GMDNR;GMDNAME;Stimmberechtigte;Abgegebene Stimmen;Beteiligung in %;Gültige Stimmzettel;Ja;Nein;Ja in %
1;Aeugst am Albis;1402;664;47.36;663;481;182;72.55
2;Affoltern am Albis;7186;2880;40.08;2850;2079;771;72.95
3;Bonstetten;3656;1701;46.53;1691;1251;440;73.98
4;Hausen am Albis;2505;1145;45.71;1132;802;330;70.85
5;Hedingen;2515;1183;47.04;1178;876;302;74.36
6;Kappel am Albis;712;281;39.47;280;187;93;66.79
7;Knonau;1482;591;39.88;584;445;139;76.2
8;Maschwanden;461;197;42.73;196;133;63;67.86
9;Mettmenstetten;3378;1740;51.51;1725;1230;495;71.3
10;Obfelden;3472;1298;37.38;1287;902;385;70.09
11;Ottenbach;1851;850;45.92;844;604;240;71.56
12;Rifferswil;749;384;51.27;381;283;98;74.28
13;Stallikon;2370;1060;44.73;1053;671;382;63.72
14;Wettswil am Albis;3421;1565;45.75;1552;1117;435;71.97
21;Adlikon;501;260;51.9;256;130;126;50.78
22;Benken (ZH);602;271;45.02;267;145;122;54.31
23;Berg am Irchel;435;264;60.69;259;138;121;53.28
24;Buch am Irchel;686;304;44.31;299;178;121;59.53
25;Dachsen;1349;571;42.33;565;437;128;77.35
26;Dorf;478;211;44.14;208;121;87;58.17
27;Feuerthalen;2271;884;38.93;877;646;231;73.66
28;Flaach;971;423;43.56;418;232;186;55.5
29;Flurlingen;1009;456;45.19;453;355;98;78.37
291;Andelfingen;1509;768;50.89;760;539;221;70.92
31;Henggart;1616;724;44.8;715;522;193;73.01
32;Humlikon;355;167;47.04;167;96;71;57.49
33;Kleinandelfingen;1444;704;48.75;693;447;246;64.5
34;Laufen-Uhwiesen;1186;542;45.7;536;387;149;72.2
35;Marthalen;1409;711;50.46;708;429;279;60.59
37;Ossingen;1170;553;47.26;545;339;206;62.2
38;Rheinau;873;442;50.63;433;326;107;75.29
39;Thalheim an der Thur;655;293;44.73;290;183;107;63.1
40;Trüllikon;824;425;51.58;415;240;175;57.83
41;Truttikon;355;193;54.37;192;102;90;53.13
43;Volken;226;104;46.02;104;53;51;50.96
292;Stammheim;2028;1273;62.77;1259;862;397;68.47
51;Bachenbülach;2503;858;34.28;845;607;238;71.83
52;Bassersdorf;7082;2490;35.16;2473;1771;702;71.61
53;Bülach;11980;4192;34.99;4164;3004;1160;72.14
54;Dietlikon;4766;1800;37.77;1788;1278;510;71.48
55;Eglisau;3191;1435;44.97;1424;1082;342;75.98
56;Embrach;5492;1884;34.3;1854;1210;644;65.26
57;Freienstein-Teufen;1681;782;46.52;776;509;267;65.59
58;Glattfelden;3124;1114;35.66;1102;634;468;57.53
59;Hochfelden;1322;539;40.77;529;335;194;63.33
60;Höri;1530;471;30.78;469;267;202;56.93
61;Hüntwangen;717;309;43.1;308;205;103;66.56
62;Kloten;10820;3107;28.72;3085;2009;1076;65.12
63;Lufingen;1481;568;38.35;565;347;218;61.42
64;Nürensdorf;3880;1683;43.38;1669;1027;642;61.53
65;Oberembrach;806;402;49.88;397;211;186;53.15
66;Opfikon;8992;2359;26.23;2343;1525;818;65.09
67;Rafz;2863;1248;43.59;1234;803;431;65.07
68;Rorbas;1612;530;32.88;522;330;192;63.22
69;Wallisellen;9158;3392;37.04;3373;2357;1016;69.88
70;Wasterkingen;411;170;41.36;170;120;50;70.59
71;Wil (ZH);1013;461;45.51;456;314;142;68.86
72;Winkel;3243;1410;43.48;1399;865;534;61.83
81;Bachs;425;204;48;199;120;79;60.3
82;Boppelsen;939;418;44.52;415;262;153;63.13
83;Buchs (ZH);3795;1138;29.99;1126;693;433;61.55
84;Dällikon;2380;761;31.97;757;447;310;59.05
85;Dänikon;1107;436;39.39;436;266;170;61.01
86;Dielsdorf;3371;1083;32.13;1070;694;376;64.86
87;Hüttikon;585;221;37.78;220;133;87;60.45
88;Neerach;2344;962;41.04;947;588;359;62.09
89;Niederglatt;2993;980;32.74;974;602;372;61.81
90;Niederhasli;5488;1777;32.38;1763;1143;620;64.83
91;Niederweningen;2031;926;45.59;915;637;278;69.62
92;Oberglatt;3503;997;28.46;988;653;335;66.09
93;Oberweningen;1182;542;45.85;534;354;180;66.29
94;Otelfingen;1787;711;39.79;706;466;240;66.01
95;Regensberg;323;158;48.92;158;121;37;76.58
96;Regensdorf;9714;3010;30.99;2991;1823;1168;60.95
97;Rümlang;4497;1397;31.07;1387;832;555;59.99
98;Schleinikon;547;245;44.79;242;157;85;64.88
99;Schöfflisdorf;966;455;47.1;449;318;131;70.82
100;Stadel;1574;571;36.28;561;313;248;55.79
101;Steinmaur;2163;832;38.47;828;511;317;61.71
102;Weiach;1094;326;29.8;325;174;151;53.54
111;Bäretswil;3607;1580;43.8;1559;973;586;62.41
112;Bubikon;5155;1790;34.72;1783;1277;506;71.62
113;Dürnten;4980;1772;35.58;1762;1241;521;70.43
114;Fischenthal;1665;707;42.46;702;350;352;49.86
115;Gossau (ZH);7065;2778;39.32;2753;1854;899;67.34
116;Grüningen;2367;983;41.53;978;630;348;64.42
117;Hinwil;7686;3001;39.05;2962;1957;1005;66.07
118;Rüti (ZH);7560;2789;36.89;2766;1951;815;70.54
119;Seegräben;960;490;51.04;484;351;133;72.52
120;Wald (ZH);6004;2131;35.49;2109;1438;671;68.18
121;Wetzikon (ZH);15086;5214;34.56;5172;3698;1474;71.5
131;Adliswil;9934;2864;28.83;2810;1566;1244;55.73
135;Kilchberg (ZH);4839;2313;47.8;2296;1518;778;66.11
136;Langnau am Albis;4488;1973;43.96;1947;1247;700;64.05
137;Oberrieden;3336;1579;47.33;1575;1095;480;69.52
138;Richterswil;8687;3512;40.43;3479;2436;1043;70.02
139;Rüschlikon;3306;1500;45.37;1478;936;542;63.33
141;Thalwil;10599;4558;43;4526;3204;1322;70.79
293;Wädenswil;15780;6430;40.75;6375;4392;1983;68.89
295;Horgen;13101;5087;38.83;5041;3453;1588;68.5
151;Erlenbach (ZH);3517;1686;47.94;1674;1083;591;64.7
152;Herrliberg;4057;2007;49.47;1992;1257;735;63.1
153;Hombrechtikon;5638;2344;41.58;2335;1619;716;69.34
154;Küsnacht (ZH);8754;4187;47.83;4141;2596;1545;62.69
155;Männedorf;7210;3360;46.6;3337;2439;898;73.09
156;Meilen;8914;4068;45.64;4028;2741;1287;68.05
157;Oetwil am See;2726;895;32.83;888;561;327;63.18
158;Stäfa;9749;4455;45.7;4421;3211;1210;72.63
159;Uetikon am See;4085;1845;45.17;1830;1243;587;67.92
160;Zumikon;3228;1723;53.38;1698;1070;628;63.02
161;Zollikon;7921;3824;48.28;3787;2547;1240;67.26
172;Fehraltorf;4174;1651;39.55;1634;1132;502;69.28
173;Hittnau;2656;1149;43.26;1139;791;348;69.45
176;Lindau;3556;1546;43.48;1532;1068;464;69.71
177;Pfäffikon;7914;3360;42.46;3340;2425;915;72.6
178;Russikon;3016;1291;42.81;1274;804;470;63.11
180;Weisslingen;2435;1029;42.26;1020;657;363;64.41
181;Wila;1404;626;44.59;625;381;244;60.96
182;Wildberg;731;377;51.57;373;243;130;65.15
296;Illnau-Effretikon;10261;4104;40;4058;2897;1161;71.39
297;Bauma;3395;1531;45.1;1515;895;620;59.08
191;Dübendorf;15375;5200;33.82;5154;3574;1580;69.34
192;Egg;5566;2437;43.78;2410;1612;798;66.89
193;Fällanden;5273;1973;37.42;1963;1331;632;67.8
194;Greifensee;3434;1460;42.52;1448;1104;344;76.24
195;Maur;6620;3160;47.73;3121;1947;1174;62.38
196;Mönchaltorf;2517;1070;42.51;1060;742;318;70
197;Schwerzenbach;3109;1166;37.5;1155;845;310;73.16
198;Uster;21648;7802;36.04;7762;5951;1811;76.67
199;Volketswil;11282;3743;33.18;3704;2360;1344;63.71
200;Wangen-Brüttisellen;4699;1558;33.16;1543;992;551;64.29
211;Altikon;524;257;49.05;257;164;93;63.81
213;Brütten;1542;760;49.29;746;507;239;67.96
214;Dägerlen;733;374;51.02;373;252;121;67.56
215;Dättlikon;551;302;54.81;299;227;72;75.92
216;Dinhard;1174;546;46.51;538;355;183;65.99
218;Ellikon an der Thur;624;276;44.23;272;188;84;69.12
219;Elsau;2425;1060;43.71;1051;744;307;70.79
220;Hagenbuch;788;298;37.82;296;167;129;56.42
221;Hettlingen;2266;1117;49.29;1108;815;293;73.56
223;Neftenbach;3862;1674;43.35;1660;1177;483;70.9
224;Pfungen;2247;839;37.34;836;595;241;71.17
225;Rickenbach (ZH);1860;841;45.22;830;579;251;69.76
226;Schlatt (ZH);514;272;52.92;265;182;83;68.68
227;Seuzach;5336;2362;44.27;2339;1634;705;69.86
228;Turbenthal;3081;1236;40.12;1223;773;450;63.21
230;Winterthur;69269;27685;39.97;27451;22248;5203;81.05
231;Zell (ZH);3755;1494;39.79;1476;1028;448;69.65
294;Elgg;3311;1492;45.06;1476;997;479;67.55
298;Wiesendangen;4683;2223;47.47;2204;1509;695;68.47
241;Aesch (ZH);957;483;50.47;471;301;170;63.91
242;Birmensdorf (ZH);3965;1743;43.96;1726;1099;627;63.67
243;Dietikon;12186;4429;36.34;4378;3157;1221;72.11
244;Geroldswil;2924;1061;36.29;1052;640;412;60.84
245;Oberengstringen;3733;1351;36.19;1336;895;441;66.99
246;Oetwil an der Limmat;1765;788;44.65;782;448;334;57.29
247;Schlieren;8287;2754;33.23;2732;1885;847;69
248;Uitikon;2907;1504;51.74;1489;915;574;61.45
249;Unterengstringen;2390;1055;44.14;1044;634;410;60.73
250;Urdorf;6043;2645;43.77;2623;1841;782;70.19
251;Weiningen (ZH);2800;1107;39.54;1098;689;409;62.75
261;Zürich;230556;92241;40.01;91491;72263;19228;78.98
9010;ZH-Ausland-CH;27785;6174;22.22;6147;5354;793;87.1
9012;ZH-Anderes;...;...;...;...;...;...;...
431;Corgémont;1150;370;32.17;366;267;99;72.95
432;Cormoret;383;131;34.2;130;102;28;78.46
433;Cortébert;483;154;31.88;149;106;43;71.14
434;Courtelary;968;308;31.82;301;231;70;76.74
435;La Ferrière;416;114;27.4;114;98;16;85.96
437;Mont-Tramelan;110;48;43.64;48;35;13;72.92
438;Orvin;914;271;29.65;264;200;64;75.76
441;Renan (BE);712;234;32.87;231;168;63;72.73
442;Romont (BE);160;51;31.88;50;32;18;64
443;Saint-Imier;3055;820;26.84;814;650;164;79.85
444;Sonceboz-Sombeval;1271;328;25.81;326;258;68;79.14
445;Sonvilier;878;241;27.45;233;167;66;71.67
446;Tramelan;3217;942;29.28;932;741;191;79.51
448;Villeret;652;287;44.02;280;209;71;74.64
449;Sauge;629;180;28.62;178;126;52;70.79
450;Péry-La Heutte;1310;321;24.5;316;219;97;69.3
681;Belprahon;242;72;29.75;70;59;11;84.29
683;Champoz;128;62;48.44;62;31;31;50
687;Corcelles (BE);174;54;31.03;54;49;5;90.74
690;Court;1037;280;27;276;180;96;65.22
691;Crémines;393;121;30.79;121;93;28;76.86
692;Eschert;274;64;23.36;62;41;21;66.13
694;Grandval;287;79;27.53;77;64;13;83.12
696;Loveresse;251;84;33.47;84;70;14;83.33
700;Moutier;4580;1303;28.45;1283;1055;228;82.23
701;Perrefitte;324;101;31.17;99;82;17;82.83
703;Reconvilier;1500;440;29.33;439;339;100;77.22
704;Roches (BE);151;37;24.5;37;21;16;56.76
706;Saicourt;475;114;24;110;69;41;62.73
707;Saules (BE);122;49;40.16;49;28;21;57.14
708;Schelten;67;25;37.31;25;20;5;80
709;Seehof;59;17;28.81;17;13;4;76.47
711;Sorvilier;226;77;34.07;76;67;9;88.16
713;Tavannes;2189;521;23.8;518;421;97;81.27
715;Rebévelier;34;22;64.71;22;12;10;54.55
716;Petit-Val;309;145;46.93;144;102;42;70.83
717;Valbirse;2638;1165;44.16;1143;834;309;72.97
723;La Neuveville;2646;934;35.3;917;775;142;84.51
724;Nods;589;172;29.2;171;132;39;77.19
726;Plateau de Diesse;1555;472;30.35;459;362;97;78.87
371;Biel/Bienne;31046;8971;28.9;8905;7313;1592;82.12
372;Evilard;1847;780;42.23;770;622;148;80.78
387;Lengnau (BE);3342;1116;33.39;1098;737;361;67.12
390;Meinisberg;949;274;28.87;274;193;81;70.44
392;Pieterlen;2532;606;23.93;600;427;173;71.17
731;Aegerten;1429;460;32.19;455;331;124;72.75
732;Bellmund;1248;439;35.18;436;337;99;77.29
733;Brügg;2831;818;28.89;811;627;184;77.31
739;Ipsach;3004;1113;37.05;1102;882;220;80.04
740;Ligerz;424;197;46.46;196;131;65;66.84
742;Mörigen;707;299;42.29;298;200;98;67.11
743;Nidau;4441;1390;31.3;1383;1122;261;81.13
744;Orpund;1931;549;28.43;545;382;163;70.09
745;Port;2679;935;34.9;930;695;235;74.73
746;Safnern;1469;482;32.81;476;294;182;61.76
747;Scheuren;349;117;33.52;115;85;30;73.91
748;Schwadernau;490;152;31.02;149;100;49;67.11
750;Sutz-Lattrigen;1042;388;37.24;383;292;91;76.24
756;Twann-Tüscherz;911;366;40.18;360;250;110;69.44
301;Aarberg;3402;1132;33.27;1124;824;300;73.31
302;Bargen (BE);771;252;32.68;251;204;47;81.27
303;Grossaffoltern;2401;839;34.94;836;617;219;73.8
304;Kallnach;1700;574;33.76;565;395;170;69.91
305;Kappelen;1081;361;33.4;358;244;114;68.16
306;Lyss;10452;3236;30.96;3219;2422;797;75.24
309;Radelfingen;1024;370;36.13;365;259;106;70.96
310;Rapperswil (BE);2159;738;34.18;733;518;215;70.67
311;Schüpfen;2904;999;34.4;995;712;283;71.56
312;Seedorf (BE);2481;889;35.83;884;599;285;67.76
381;Arch;1221;358;29.32;358;215;143;60.06
382;Büetigen;669;208;31.09;207;135;72;65.22
383;Büren an der Aare;2450;823;33.59;821;609;212;74.18
385;Diessbach bei Büren;714;248;34.73;242;162;80;66.94
386;Dotzigen;1098;352;32.06;349;257;92;73.64
388;Leuzigen;927;266;28.69;264;180;84;68.18
389;Meienried (Gemeinsame Urne, Standort: Büren an der Aare          );...;...;...;...;...;...;...
391;Oberwil bei Büren;667;222;33.28;220;157;63;71.36
393;Rüti bei Büren;653;188;28.79;184;120;64;65.22
394;Wengi;460;160;34.78;159;110;49;69.18
491;Brüttelen;417;154;36.93;143;99;44;69.23
492;Erlach;1000;369;36.9;368;287;81;77.99
493;Finsterhennen;331;108;32.63;108;71;37;65.74
494;Gals;593;186;31.37;183;140;43;76.5
495;Gampelen;638;210;32.92;208;143;65;68.75
496;Ins;2355;954;40.51;950;699;251;73.58
497;Lüscherz;434;129;29.72;129;84;45;65.12
498;Müntschemier;812;306;37.68;304;207;97;68.09
499;Siselen;448;141;31.47;140;90;50;64.29
500;Treiten;315;125;39.68;123;82;41;66.67
501;Tschugg;301;121;40.2;120;103;17;85.83
502;Vinelz;676;276;40.83;275;200;75;72.73
734;Bühl;386;116;30.05;116;76;40;65.52
735;Epsach;250;79;31.6;79;53;26;67.09
736;Hagneck;332;115;34.64;114;78;36;68.42
737;Hermrigen;257;73;28.4;73;56;17;76.71
738;Jens;533;203;38.09;203;157;46;77.34
741;Merzligen;335;125;37.31;125;96;29;76.8
749;Studen (BE);2156;620;28.76;616;430;186;69.81
751;Täuffelen;2169;763;35.18;759;567;192;74.7
754;Walperswil;777;238;30.63;238;167;71;70.17
755;Worben;1697;604;35.59;600;419;181;69.83
321;Aarwangen;3176;1082;34.07;1070;717;353;67.01
322;Auswil;380;136;35.79;131;82;49;62.6
323;Bannwil;515;177;34.37;177;111;66;62.71
324;Bleienbach;563;204;36.23;202;103;99;50.99
325;Busswil bei Melchnau;177;72;40.68;72;36;36;50
326;Gondiswil;609;174;28.57;173;101;72;58.38
329;Langenthal;10520;3475;33.03;3458;2675;783;77.36
331;Lotzwil;1747;590;33.77;582;438;144;75.26
332;Madiswil;2608;944;36.2;931;621;310;66.7
333;Melchnau;1105;333;30.14;330;228;102;69.09
335;Oeschenbach;205;54;26.34;50;38;12;76
336;Reisiswil;152;44;28.95;44;26;18;59.09
337;Roggwil (BE);2850;882;30.95;879;639;240;72.7
338;Rohrbach;1215;337;27.74;333;202;131;60.66
339;Rohrbachgraben;328;110;33.54;110;77;33;70
340;Rütschelen;431;145;33.64;143;101;42;70.63
341;Schwarzhäusern;422;138;32.7;138;86;52;62.32
342;Thunstetten;2319;659;28.42;652;443;209;67.94
344;Ursenbach;729;212;29.08;207;119;88;57.49
345;Wynau;1081;315;29.14;303;192;111;63.37
953;Eriswil;1118;259;23.17;258;163;95;63.18
954;Huttwil;3614;1098;30.38;1091;779;312;71.4
959;Walterswil (BE);457;120;26.26;119;65;54;54.62
960;Wyssachen;972;254;26.13;249;149;100;59.84
971;Attiswil;1126;377;33.48;369;248;121;67.21
972;Berken;42;22;52.38;22;12;10;54.55
973;Bettenhausen;543;185;34.07;181;121;60;66.85
975;Farnern;175;53;30.29;53;36;17;67.92
976;Graben;263;85;32.32;85;43;42;50.59
977;Heimenhausen;873;277;31.73;274;198;76;72.26
979;Herzogenbuchsee;4871;1664;34.16;1658;1226;432;73.94
980;Inkwil;533;191;35.83;186;106;80;56.99
981;Niederbipp;3183;863;27.11;860;536;324;62.33
982;Niederönz;1240;455;36.69;450;339;111;75.33
983;Oberbipp;1224;432;35.29;430;279;151;64.88
985;Ochlenberg;477;180;37.74;178;104;74;58.43
987;Rumisberg;391;146;37.34;145;80;65;55.17
988;Seeberg;1300;460;35.38;455;292;163;64.18
989;Thörigen;865;298;34.45;295;192;103;65.08
990;Walliswil bei Niederbipp;171;64;37.43;63;40;23;63.49
991;Walliswil bei Wangen;505;166;32.87;164;99;65;60.37
992;Wangen an der Aare;1651;534;32.34;534;363;171;67.98
993;Wangenried;345;122;35.36;122;76;46;62.3
995;Wiedlisbach;1672;479;28.65;473;329;144;69.56
401;Aefligen;840;257;30.6;255;160;95;62.75
402;Alchenstorf;462;137;29.65;137;94;43;68.61
404;Burgdorf;11767;3996;33.96;3969;3110;859;78.36
405;Ersigen;1644;599;36.44;597;380;217;63.65
406;Hasle bei Burgdorf;2600;695;26.73;688;465;223;67.59
407;Heimiswil;1310;418;31.91;416;276;140;66.35
408;Hellsau (Gemeinsame Urne, Standort: Höchstetten                );...;...;...;...;...;...;...
409;Hindelbank;2031;648;31.91;646;453;193;70.12
410;Höchstetten;380;118;31.05;114;67;47;58.77
411;Kernenried;431;163;37.82;163;108;55;66.26
412;Kirchberg (BE);4266;1580;37.04;1571;1084;487;69
413;Koppigen;1657;535;32.29;526;374;152;71.1
414;Krauchthal;1894;607;32.05;595;378;217;63.53
415;Lyssach;1117;396;35.45;385;273;112;70.91
418;Oberburg;1976;563;28.49;562;351;211;62.46
420;Rüdtligen-Alchenflüh;1542;380;24.64;377;256;121;67.9
421;Rumendingen;60;32;53.33;32;16;16;50
422;Rüti bei Lyssach;...;...;...;...;...;...;...
423;Willadingen;172;68;39.53;68;35;33;51.47
424;Wynigen;1693;592;34.97;590;365;225;61.86
533;Bätterkinden;2521;904;35.86;894;643;251;71.92
552;Utzenstorf;3327;1128;33.9;1124;791;333;70.37
554;Wiler bei Utzenstorf;709;216;30.47;212;159;53;75
556;Zielebach;257;71;27.63;69;47;22;68.12
901;Eggiwil;2008;435;21.66;426;233;193;54.69
902;Langnau im Emmental;7546;2397;31.77;2378;1800;578;75.69
903;Lauperswil;2197;552;25.13;544;365;179;67.1
904;Röthenbach im Emmental;1022;241;23.58;240;128;112;53.33
905;Rüderswil;1984;507;25.55;504;324;180;64.29
906;Schangnau;763;191;25.03;188;111;77;59.04
907;Signau;2176;650;29.87;645;394;251;61.09
908;Trub;1377;334;24.26;331;227;104;68.58
909;Trubschachen;1158;350;30.22;346;251;95;72.54
951;Affoltern im Emmental;943;324;34.36;314;172;142;54.78
952;Dürrenroth;862;222;25.75;220;152;68;69.09
955;Lützelflüh;3302;1059;32.07;1045;700;345;66.99
956;Rüegsau;2647;1174;44.35;1163;709;454;60.96
957;Sumiswald;4196;1091;26;1081;722;359;66.79
958;Trachselwald;793;210;26.48;207;118;89;57
307;Meikirch;1981;897;45.28;885;641;244;72.43
351;Bern;88303;35825;40.57;35566;28537;7029;80.24
352;Bolligen;4799;2311;48.16;2291;1647;644;71.89
353;Bremgarten bei Bern;3252;1605;49.35;1597;1191;406;74.58
354;Kirchlindach;2363;1123;47.52;1107;792;315;71.54
355;Köniz;28464;11571;40.65;11499;8399;3100;73.04
356;Muri bei Bern;9365;4432;47.33;4398;3019;1379;68.64
357;Oberbalm;705;225;31.91;223;116;107;52.02
358;Stettlen;2247;939;41.79;934;625;309;66.92
359;Vechigen;4039;1647;40.78;1638;1097;541;66.97
360;Wohlen bei Bern;7033;3259;46.34;3229;2369;860;73.37
361;Zollikofen;6784;2831;41.73;2803;1953;850;69.68
362;Ittigen;7366;2627;35.66;2615;1774;841;67.84
363;Ostermundigen;10641;3373;31.7;3344;2468;876;73.8
403;Bäriswil;828;362;43.72;359;248;111;69.08
535;Deisswil bei Münchenbuchsee (Gemeinsame Urne, Standort: Wiggiswil                  );...;...;...;...;...;...;...
536;Diemerswil;158;63;39.87;62;49;13;79.03
538;Fraubrunnen;3884;1462;37.64;1448;1032;416;71.27
540;Jegenstorf;4269;1773;41.53;1759;1321;438;75.1
541;Iffwil;336;117;34.82;116;74;42;63.79
543;Mattstetten;458;192;41.92;188;125;63;66.49
544;Moosseedorf;2781;929;33.41;923;621;302;67.28
546;Münchenbuchsee;6976;3078;44.12;3047;2229;818;73.15
551;Urtenen-Schönbühl;4201;1318;31.37;1313;900;413;68.55
553;Wiggiswil;152;77;50.66;76;43;33;56.58
557;Zuzwil (BE);456;229;50.22;227;156;71;68.72
602;Arni (BE);755;233;30.86;230;133;97;57.83
603;Biglen;1434;454;31.66;451;318;133;70.51
605;Bowil;1105;284;25.7;283;172;111;60.78
606;Brenzikofen;414;145;35.02;145;86;59;59.31
607;Freimettigen;355;123;34.65;123;93;30;75.61
608;Grosshöchstetten;3211;1192;37.12;1172;828;344;70.65
609;Häutligen;219;79;36.07;78;33;45;42.31
610;Herbligen;459;127;27.67;126;90;36;71.43
611;Kiesen;725;244;33.66;244;154;90;63.11
612;Konolfingen;4069;1414;34.75;1405;1021;384;72.67
613;Landiswil;547;148;27.06;147;82;65;55.78
614;Linden;1072;290;27.05;289;183;106;63.32
615;Mirchel;478;136;28.45;135;94;41;69.63
616;Münsingen;9346;3630;38.84;3604;2713;891;75.28
617;Niederhünigen;536;196;36.57;195;156;39;80
619;Oberdiessbach;2704;886;32.77;872;589;283;67.55
620;Oberthal;625;171;27.36;171;107;64;62.57
622;Oppligen;525;163;31.05;162;122;40;75.31
623;Rubigen;2292;824;35.95;822;606;216;73.72
626;Walkringen;1461;429;29.36;423;271;152;64.07
627;Worb;8054;3070;38.12;3052;2249;803;73.69
628;Zäziwil;1236;363;29.37;362;254;108;70.17
629;Oberhünigen;238;77;32.35;74;35;39;47.3
630;Allmendingen;448;226;50.45;226;138;88;61.06
632;Wichtrach;3276;1020;31.14;1014;710;304;70.02
662;Ferenbalm;977;366;37.46;358;230;128;64.25
663;Frauenkappelen;949;359;37.83;355;216;139;60.85
665;Gurbrü;190;72;37.89;71;50;21;70.42
666;Kriechenwil;352;115;32.67;115;67;48;58.26
667;Laupen;2236;909;40.65;902;656;246;72.73
668;Mühleberg;2307;858;37.19;857;490;367;57.18
669;Münchenwiler;393;144;36.64;140;83;57;59.29
670;Neuenegg;3961;1299;32.79;1291;841;450;65.14
671;Wileroltigen;287;96;33.45;95;52;43;54.74
852;Guggisberg;1310;338;25.8;330;158;172;47.88
853;Rüschegg;1430;392;27.41;388;227;161;58.51
855;Schwarzenburg;5523;1867;33.8;1852;1221;631;65.93
861;Belp;8316;3026;36.39;3000;2006;994;66.87
866;Gerzensee;933;355;38.05;352;202;150;57.39
868;Jaberg;217;84;38.71;84;56;28;66.67
869;Kaufdorf;789;339;42.97;337;249;88;73.89
870;Kehrsatz;2677;1021;38.14;1014;699;315;68.93
872;Kirchdorf (BE);1484;516;34.77;512;328;184;64.06
877;Niedermuhlern (Gemeinsame Urne, Standort: Wald (BE)                  );...;...;...;...;...;...;...
879;Riggisberg;2344;720;30.72;716;431;285;60.2
880;Rüeggisberg;1548;461;29.78;458;247;211;53.93
884;Toffen;1928;759;39.37;745;485;260;65.1
888;Wald (BE);1362;500;36.71;498;308;190;61.85
889;Thurnen;1491;610;40.91;602;425;177;70.6
767;Reutigen;772;268;34.72;265;152;113;57.36
770;Stocken-Höfen;804;237;29.48;235;146;89;62.13
863;Burgistein;893;293;32.81;286;182;104;63.64
867;Gurzelen;632;201;31.8;198;141;57;71.21
883;Seftigen;1643;567;34.51;565;409;156;72.39
885;Uttigen;1625;596;36.68;589;420;169;71.31
886;Wattenwil;2329;642;27.57;636;434;202;68.24
921;Amsoldingen;678;271;39.97;264;181;83;68.56
922;Blumenstein;1024;289;28.22;287;189;98;65.85
923;Buchholterberg;1258;381;30.29;380;183;197;48.16
924;Eriz;432;126;29.17;124;45;79;36.29
925;Fahrni;638;191;29.94;189;93;96;49.21
927;Heiligenschwendi;523;200;38.24;198;136;62;68.69
928;Heimberg;5021;1942;38.68;1923;1296;627;67.39
929;Hilterfingen;3148;1286;40.85;1272;957;315;75.24
931;Homberg;385;113;29.35;112;64;48;57.14
932;Horrenbach-Buchen;176;47;26.7;47;23;24;48.94
934;Oberhofen am Thunersee;1870;861;46.04;845;587;258;69.47
935;Oberlangenegg;381;104;27.3;103;38;65;36.89
936;Pohlern;187;52;27.81;51;26;25;50.98
938;Sigriswil;3977;1425;35.83;1416;815;601;57.56
939;Steffisburg;12104;4223;34.89;4203;3074;1129;73.14
940;Teuffenthal (BE);151;49;32.45;49;25;24;51.02
941;Thierachern;1844;640;34.71;640;473;167;73.91
942;Thun;32823;11313;34.47;11229;8614;2615;76.71
943;Uebeschi;527;185;35.1;181;121;60;66.85
944;Uetendorf;4629;1575;34.02;1566;1086;480;69.35
945;Unterlangenegg;801;237;29.59;237;134;103;56.54
946;Wachseldorn;185;51;27.57;50;18;32;36
947;Zwieselberg;241;75;31.12;75;47;28;62.67
948;Forst-Längenbühl;617;203;32.9;202;147;55;72.77
791;Boltigen;1068;251;23.5;244;135;109;55.33
792;Lenk;1832;544;29.69;536;361;175;67.35
793;St. Stephan;1058;367;34.69;362;212;150;58.56
794;Zweisimmen;2318;763;32.92;752;489;263;65.03
841;Gsteig;703;190;27.03;188;120;68;63.83
842;Lauenen;629;212;33.7;204;130;74;63.73
843;Saanen;4363;1453;33.3;1433;960;473;66.99
561;Adelboden;2663;957;35.94;948;594;354;62.66
562;Aeschi bei Spiez;1743;643;36.89;639;407;232;63.69
563;Frutigen;5358;1727;32.23;1708;1085;623;63.52
564;Kandergrund;630;141;22.38;137;56;81;40.88
565;Kandersteg;889;337;37.91;336;217;119;64.58
566;Krattigen;901;310;34.41;299;220;79;73.58
567;Reichenbach im Kandertal;2816;835;29.65;827;488;339;59.01
761;Därstetten;676;176;26.04;174;79;95;45.4
762;Diemtigen;1793;462;25.77;461;274;187;59.44
763;Erlenbach im Simmental;1391;386;27.75;382;273;109;71.47
766;Oberwil im Simmental;663;193;29.11;188;113;75;60.11
768;Spiez;9821;3530;35.94;3516;2607;909;74.15
769;Wimmis;1886;567;30.06;565;338;227;59.82
571;Beatenberg;904;314;34.73;312;174;138;55.77
572;Bönigen;1953;601;30.77;598;406;192;67.89
573;Brienz (BE);2391;747;31.24;740;489;251;66.08
574;Brienzwiler;374;118;31.55;116;63;53;54.31
575;Därligen;303;78;25.74;77;56;21;72.73
576;Grindelwald;2672;768;28.74;759;430;329;56.65
577;Gsteigwiler;324;129;39.81;129;98;31;75.97
578;Gündlischwand;232;72;31.03;69;30;39;43.48
579;Habkern;508;129;25.39;124;65;59;52.42
580;Hofstetten bei Brienz;434;130;29.95;127;81;46;63.78
581;Interlaken;3424;1172;34.23;1164;863;301;74.14
582;Iseltwald;343;105;30.61;105;69;36;65.71
584;Lauterbrunnen;1539;456;29.63;448;284;164;63.39
585;Leissigen;840;289;34.4;288;210;78;72.92
586;Lütschental;183;45;24.59;45;15;30;33.33
587;Matten bei Interlaken;2835;868;30.62;859;620;239;72.18
588;Niederried bei Interlaken;271;80;29.52;80;56;24;70
589;Oberried am Brienzersee;374;103;27.54;101;70;31;69.31
590;Ringgenberg (BE);1992;552;27.71;550;377;173;68.55
591;Saxeten;96;21;21.88;21;13;8;61.9
592;Schwanden bei Brienz;481;157;32.64;156;111;45;71.15
593;Unterseen;4107;1449;35.28;1442;1090;352;75.59
594;Wilderswil;1931;607;31.43;603;422;181;69.98
782;Guttannen;225;61;27.11;61;37;24;60.66
783;Hasliberg;847;241;28.45;240;156;84;65
784;Innertkirchen;848;242;28.54;239;135;104;56.49
785;Meiringen;3243;1065;32.84;1061;748;313;70.5
786;Schattenhalb;432;108;25;108;70;38;64.81
9020;BE-Ausland-CH;...;...;...;...;...;...;...
9022;BE-Anderes;...;...;...;...;...;...;...
1061;Luzern;53034;20376;38.42;20163;14858;5305;73.69
1051;Adligenswil;3883;2018;51.97;1989;1412;577;70.99
1052;Buchrain;4017;1455;36.22;1436;1060;376;73.82
1053;Dierikon;976;297;30.43;289;171;118;59.17
1054;Ebikon;8778;2906;33.11;2846;2013;833;70.73
1055;Gisikon;888;343;38.63;339;222;117;65.49
1056;Greppen;717;314;43.79;312;195;117;62.5
1057;Honau;295;118;40;116;74;42;63.79
1058;Horw;9726;4324;44.46;4283;3101;1182;72.4
1059;Kriens;18482;7116;38.5;7061;4949;2112;70.09
1062;Malters;5227;1883;36.02;1867;1233;634;66.04
1063;Meggen;5111;2499;48.89;2480;1596;884;64.35
1064;Meierskappel;941;352;37.41;344;229;115;66.57
1065;Root;2993;902;30.14;896;636;260;70.98
1066;Schwarzenberg;1260;502;39.84;499;277;222;55.51
1067;Udligenswil;1604;724;45.14;710;483;227;68.03
1068;Vitznau;873;395;45.25;394;235;159;59.64
1069;Weggis;2922;1275;43.63;1261;798;463;63.28
1021;Aesch (LU);906;337;37.2;337;217;120;64.39
1023;Ballwil;1948;765;39.27;753;491;262;65.21
1024;Emmen;16878;5986;35.47;5948;4148;1800;69.74
1025;Ermensee;689;293;42.53;290;176;114;60.69
1026;Eschenbach (LU);2563;1108;43.23;1083;724;359;66.85
1030;Hitzkirch;3865;1589;41.11;1553;1010;543;65.04
1031;Hochdorf;6241;2183;34.98;2157;1598;559;74.08
1032;Hohenrain;1759;667;37.92;652;414;238;63.5
1033;Inwil;1757;602;34.26;596;387;209;64.93
1037;Rain;1961;808;41.2;800;535;265;66.88
1039;Römerswil;1262;632;50.08;630;386;244;61.27
1040;Rothenburg;5439;2406;44.24;2380;1733;647;72.82
1041;Schongau;756;383;50.66;381;231;150;60.63
1081;Beromünster;4469;1661;37.17;1627;1131;496;69.51
1082;Büron;1471;502;34.13;495;339;156;68.48
1083;Buttisholz;2199;912;41.47;891;596;295;66.89
1084;Eich;1266;537;42.42;535;349;186;65.23
1085;Geuensee;1752;520;29.68;520;395;125;75.96
1086;Grosswangen;2203;778;35.32;770;459;311;59.61
1088;Hildisrieden;1700;716;42.12;712;494;218;69.38
1089;Knutwil;1582;565;35.71;560;410;150;73.21
1091;Mauensee;1082;408;37.71;408;292;116;71.57
1093;Neuenkirch;4994;1763;35.3;1744;1221;523;70.01
1094;Nottwil;2647;1035;39.1;1020;710;310;69.61
1095;Oberkirch;3273;1341;40.97;1325;1025;300;77.36
1097;Rickenbach (LU);2127;767;36.06;764;486;278;63.61
1098;Ruswil;5055;1798;35.57;1780;1204;576;67.64
1099;Schenkon;2183;872;39.95;867;586;281;67.59
1100;Schlierbach;613;278;45.35;277;172;105;62.09
1102;Sempach;2981;1509;50.62;1495;1142;353;76.39
1103;Sursee;6914;2733;39.53;2689;2138;551;79.51
1104;Triengen;2780;975;35.07;960;629;331;65.52
1121;Alberswil;467;160;34.26;160;101;59;63.13
1122;Altbüron;737;256;34.74;250;162;88;64.8
1123;Altishofen;1295;741;57.22;711;476;235;66.95
1125;Dagmersellen;3623;1174;32.4;1162;722;440;62.13
1127;Egolzwil;1092;371;33.97;367;264;103;71.93
1128;Ettiswil;1924;621;32.28;610;397;213;65.08
1129;Fischbach;523;172;32.89;172;67;105;38.95
1131;Grossdietwil;632;238;37.66;235;127;108;54.04
1132;Hergiswil bei Willisau;1374;490;35.66;484;210;274;43.39
1135;Luthern;948;323;34.07;318;157;161;49.37
1136;Menznau;2052;686;33.43;673;382;291;56.76
1137;Nebikon;1476;515;34.89;507;313;194;61.74
1139;Pfaffnau;1812;615;33.94;608;371;237;61.02
1140;Reiden;4368;1502;34.39;1488;999;489;67.14
1142;Roggliswil;528;180;34.09;178;117;61;65.73
1143;Schötz;2826;917;32.45;904;561;343;62.06
1145;Ufhusen;672;229;34.08;226;120;106;53.1
1146;Wauwil;1377;475;34.5;473;306;167;64.69
1147;Wikon;993;368;37.06;364;241;123;66.21
1150;Zell (LU);1447;478;33.03;471;285;186;60.51
1151;Willisau;6234;2449;39.28;2417;1584;833;65.54
1001;Doppleschwand;568;194;34.15;192;99;93;51.56
1002;Entlebuch;2475;911;36.81;901;476;425;52.83
1004;Flühli;1280;530;41.41;523;259;264;49.52
1005;Hasle (LU);1348;499;37.02;496;221;275;44.56
1007;Romoos;508;184;36.22;182;93;89;51.1
1008;Schüpfheim;3148;1166;37.04;1157;693;464;59.9
1009;Werthenstein;1444;485;33.59;482;251;231;52.07
1010;Escholzmatt-Marbach;3337;1177;35.27;1157;574;583;49.61
1107;Wolhusen;2827;1063;37.6;1055;633;422;60
9030;LU-Ausland-CH;4944;1461;29.55;1440;1254;186;87.08
1201;Altdorf (UR);6589;1975;29.97;1953;1481;472;75.83
1202;Andermatt;906;244;26.93;244;169;75;69.26
1203;Attinghausen;1243;273;21.96;270;176;94;65.19
1205;Bürglen (UR);3035;782;25.77;771;488;283;63.29
1206;Erstfeld;2531;842;33.27;829;594;235;71.65
1207;Flüelen;1402;376;26.82;374;240;134;64.17
1208;Göschenen;302;110;36.42;110;65;45;59.09
1209;Gurtnellen;413;109;26.39;105;36;69;34.29
1210;Hospental;143;46;32.17;46;22;24;47.83
1211;Isenthal;382;104;27.23;103;57;46;55.34
1212;Realp;120;54;45;53;30;23;56.6
1213;Schattdorf;4007;1004;25.06;994;661;333;66.5
1214;Seedorf (UR);1417;388;27.38;386;300;86;77.72
1215;Seelisberg;481;171;35.55;166;91;75;54.82
1216;Silenen;1519;329;21.66;324;195;129;60.19
1217;Sisikon;242;69;28.51;69;44;25;63.77
1218;Spiringen;670;129;19.25;127;59;68;46.46
1219;Unterschächen;553;100;18.08;96;26;70;27.08
1220;Wassen;271;162;59.78;135;64;71;47.41
9040;UR-Ausland-CH;472;126;26.69;125;112;13;89.6
1301;Einsiedeln;11016;4205;38.17;4192;2731;1461;65.15
1311;Gersau;1555;645;41.48;644;377;267;58.54
1321;Feusisberg;3254;1286;39.52;1280;769;511;60.08
1322;Freienbach;10137;4152;40.96;4138;2560;1578;61.87
1323;Wollerau;4695;2132;45.41;2122;1246;876;58.72
1331;Küssnacht (SZ);8463;4039;47.73;4025;2733;1292;67.9
1341;Altendorf;4679;1726;36.89;1716;1069;647;62.3
1342;Galgenen;3390;1230;36.28;1226;746;480;60.85
1343;Innerthal;145;64;44.14;64;30;34;46.88
1344;Lachen;5212;1903;36.51;1900;1369;531;72.05
1345;Reichenburg;2296;930;40.51;919;550;369;59.85
1346;Schübelbach;5429;1615;29.75;1608;985;623;61.26
1347;Tuggen;2278;705;30.95;705;430;275;60.99
1348;Vorderthal;813;225;27.68;225;107;118;47.56
1349;Wangen (SZ);3593;1313;36.54;1306;815;491;62.4
1361;Alpthal;462;164;35.5;164;71;93;43.29
1362;Arth;7190;2704;37.61;2693;1680;1013;62.38
1363;Illgau;616;199;32.31;199;123;76;61.81
1364;Ingenbohl;6080;2551;41.96;2543;1814;729;71.33
1365;Lauerz;762;310;40.68;307;168;139;54.72
1366;Morschach;733;276;37.65;276;151;125;54.71
1367;Muotathal;2676;968;36.17;966;457;509;47.31
1368;Oberiberg;711;297;41.77;297;154;143;51.85
1369;Riemenstalden;56;24;42.86;24;7;17;29.17
1370;Rothenthurm;1564;556;35.55;552;269;283;48.73
1371;Sattel;1368;532;38.89;530;241;289;45.47
1372;Schwyz;10448;4044;38.71;4028;2634;1394;65.39
1373;Steinen;2537;921;36.3;918;598;320;65.14
1374;Steinerberg;710;247;34.79;245;107;138;43.67
1375;Unteriberg;1820;636;34.95;634;269;365;42.43
9050;SZ-Ausland-CH;...;...;...;...;...;...;...
9051;SZ-Korrespondenzweg;...;...;...;...;...;...;...
9052;SZ-Anderes;...;...;...;...;...;...;...
1401;Alpnach;4197;1625;38.72;1581;866;715;54.78
1402;Engelberg;2726;1452;53.26;1412;818;594;57.93
1403;Giswil;2665;944;35.42;929;499;430;53.71
1404;Kerns;4546;1720;37.84;1676;910;766;54.3
1405;Lungern;1544;644;41.71;627;329;298;52.47
1406;Sachseln;3682;1680;45.63;1652;998;654;60.41
1407;Sarnen;7371;3154;42.79;3068;1844;1224;60.1
9060;OW-Ausland-CH;...;...;...;...;...;...;...
1501;Beckenried;2683;1048;39.06;1034;680;354;65.76
1502;Buochs;3875;1492;38.5;1477;956;521;64.73
1503;Dallenwil;1419;560;39.46;557;331;226;59.43
1504;Emmetten;1020;384;37.65;376;210;166;55.85
1505;Ennetbürgen;3481;1452;41.71;1436;911;525;63.44
1506;Ennetmoos;1574;561;35.64;552;357;195;64.67
1507;Hergiswil (NW);3997;1618;40.48;1602;939;663;58.61
1508;Oberdorf (NW);2365;1049;44.36;1037;653;384;62.97
1509;Stans;6073;2532;41.69;2503;1817;686;72.59
1510;Stansstad;3273;1288;39.35;1278;780;498;61.03
1511;Wolfenschiessen;1557;578;37.12;569;332;237;58.35
9070;NW-Ausland-CH;...;...;...;...;...;...;...
9072;NW-Anderes;...;...;...;...;...;...;...
1630;Glarus Nord;11590;3035;26.19;3008;1934;1074;64.3
1631;Glarus Süd;7029;2218;31.55;2195;1264;931;57.59
1632;Glarus;7856;2313;29.44;2293;1528;765;66.64
9080;GL-Ausland-CH;...;...;...;...;...;...;...
1701;Baar;14470;6173;42.66;6150;4582;1568;74.5
1702;Cham;10384;4390;42.28;4379;3303;1076;75.43
1703;Hünenberg;5989;2871;47.94;2862;2179;683;76.14
1704;Menzingen;3086;1507;48.83;1505;994;511;66.05
1705;Neuheim;1434;657;45.82;656;441;215;67.23
1706;Oberägeri;3708;1657;44.69;1640;1067;573;65.06
1707;Risch;6503;2501;38.46;2490;1768;722;71
1708;Steinhausen;6324;2812;44.47;2802;2183;619;77.91
1709;Unterägeri;5571;2415;43.35;2408;1715;693;71.22
1710;Walchwil;2094;1031;49.24;1029;650;379;63.17
1711;Zug;17246;8315;48.21;8280;6220;2060;75.12
9090;ZG-Ausland-CH;...;...;...;...;...;...;...
2008;Châtillon (FR);336;145;43.15;144;112;32;77.78
2011;Cugy (FR);1128;433;38.39;432;325;107;75.23
2016;Fétigny;689;204;29.61;201;153;48;76.12
2022;Gletterens;714;235;32.91;230;144;86;62.61
2025;Lully (FR);707;256;36.21;254;190;64;74.8
2027;Ménières;280;104;37.14;103;73;30;70.87
2029;Montagny (FR);1771;512;28.91;506;383;123;75.69
2035;Nuvilly;295;106;35.93;105;70;35;66.67
2038;Prévondavaux;43;21;48.84;21;11;10;52.38
2041;Saint-Aubin (FR);1093;372;34.03;370;301;69;81.35
2043;Sévaz;167;68;40.72;67;59;8;88.06
2044;Surpierre;796;226;28.39;222;157;65;70.72
2045;Vallon;287;94;32.75;93;72;21;77.42
2050;Les Montets;925;279;30.16;276;196;80;71.01
2051;Delley-Portalban;819;262;31.99;254;192;62;75.59
2053;Belmont-Broye;3196;982;30.73;960;713;247;74.27
2054;Estavayer;5947;1882;31.65;1860;1470;390;79.03
2055;Cheyres-Châbles;1571;539;34.31;535;395;140;73.83
2061;Auboranges;197;76;38.58;75;57;18;76
2063;Billens-Hennens;541;273;50.46;272;195;77;71.69
2066;Chapelle (Glâne);192;95;49.48;94;73;21;77.66
2067;Le Châtelard;266;70;26.32;68;42;26;61.76
2068;Châtonnaye;565;172;30.44;169;129;40;76.33
2072;Ecublens (FR);254;109;42.91;107;87;20;81.31
2079;Grangettes;140;63;45;62;40;22;64.52
2086;Massonnens;359;142;39.55;139;96;43;69.06
2087;Mézières (FR);739;224;30.31;217;153;64;70.51
2089;Montet (Glâne);251;78;31.08;76;54;22;71.05
2096;Romont (FR);2524;775;30.71;769;582;187;75.68
2097;Rue;1039;322;30.99;316;242;74;76.58
2099;Siviriez;1494;485;32.46;475;354;121;74.53
2102;Ursy;2044;558;27.3;542;398;144;73.43
2113;Vuisternens-devant-Romont;1592;467;29.33;454;323;131;71.15
2114;Villorsonnens;975;348;35.69;340;192;148;56.47
2115;Torny;609;185;30.38;182;147;35;80.77
2117;Villaz;1487;499;33.56;493;362;131;73.43
2121;Haut-Intyamon;1004;341;33.96;329;228;101;69.3
2122;Pont-en-Ogoz;1284;445;34.66;436;337;99;77.29
2123;Botterens;384;150;39.06;149;89;60;59.73
2124;Broc;1515;495;32.67;491;379;112;77.19
2125;Bulle;11410;3429;30.05;3381;2737;644;80.95
2128;Châtel-sur-Montsalvens;170;74;43.53;74;53;21;71.62
2129;Corbières;600;229;38.17;225;157;68;69.78
2130;Crésuz;235;94;40;94;70;24;74.47
2131;Echarlens;549;147;26.78;146;105;41;71.92
2134;Grandvillard;571;175;30.65;172;137;35;79.65
2135;Gruyères;1351;435;32.2;431;335;96;77.73
2137;Hauteville;449;138;30.73;135;90;45;66.67
2138;Jaun;507;161;31.76;158;80;78;50.63
2140;Marsens;1203;389;32.34;382;321;61;84.03
2143;Morlon;422;161;38.15;158;116;42;73.42
2145;Le Pâquier (FR);843;313;37.13;304;245;59;80.59
2147;Pont-la-Ville;420;151;35.95;149;107;42;71.81
2148;Riaz;1734;531;30.62;524;395;129;75.38
2149;La Roche;1116;320;28.67;315;199;116;63.17
2152;Sâles;1025;353;34.44;349;264;85;75.64
2153;Sorens;741;261;35.22;252;189;63;75
2155;Vaulruz;710;266;37.46;258;187;71;72.48
2160;Vuadens;1533;472;30.79;469;346;123;73.77
2162;Bas-Intyamon;914;255;27.9;253;189;64;74.7
2163;Val-de-Charmey;1674;590;35.24;580;442;138;76.21
2173;Autigny;522;169;32.38;168;121;47;72.02
2174;Avry;1198;469;39.15;466;378;88;81.12
2175;Belfaux;1850;650;35.14;640;506;134;79.06
2177;Chénens;536;144;26.87;138;104;34;75.36
2183;Corminboeuf;1822;743;40.78;735;577;158;78.5
2186;Cottens (FR);923;343;37.16;341;257;84;75.37
2194;Ferpicloz;181;72;39.78;72;43;29;59.72
2196;Fribourg;20378;7903;38.78;7808;6444;1364;82.53
2197;Givisiez;1605;503;31.34;482;389;93;80.71
2198;Granges-Paccot;1927;517;26.83;514;397;117;77.24
2200;Grolley;1199;408;34.03;402;326;76;81.09
2206;Marly;4826;1927;39.93;1915;1560;355;81.46
2208;Matran;1000;397;39.7;397;326;71;82.12
2211;Neyruz (FR);1655;610;36.86;597;501;96;83.92
2216;Pierrafortscha;108;55;50.93;54;36;18;66.67
2217;Ponthaux;503;159;31.61;156;119;37;76.28
2220;Le Mouret;2278;722;31.69;704;493;211;70.03
2226;Treyvaux;1025;403;39.32;398;287;111;72.11
2228;Villars-sur-Glâne;6549;2470;37.72;2454;2047;407;83.41
2230;Villarsel-sur-Marly;52;31;59.62;30;22;8;73.33
2233;Hauterive (FR);1636;492;30.07;488;403;85;82.58
2234;La Brillaz;1319;434;32.9;432;360;72;83.33
2235;La Sonnaz;796;242;30.4;240;196;44;81.67
2236;Gibloux;4841;1586;32.76;1563;1229;334;78.63
2237;Prez;1501;505;33.64;498;403;95;80.92
2238;Bois-d'Amont;1467;564;38.45;562;423;139;75.27
2250;Courgevaux;833;301;36.13;298;229;69;76.85
2254;Courtepin;2831;878;31.01;868;682;186;78.57
2257;Cressier (FR);606;223;36.8;223;169;54;75.78
2258;Fräschels;355;158;44.51;158;108;50;68.35
2261;Greng;128;63;49.22;62;40;22;64.52
2262;Gurmels;3043;943;30.99;937;664;273;70.86
2265;Kerzers;3063;1028;33.56;1023;636;387;62.17
2266;Kleinbösingen;512;177;34.57;175;119;56;68
2271;Meyriez;450;218;48.44;218;171;47;78.44
2272;Misery-Courtion;1132;293;25.88;291;221;70;75.95
2274;Muntelier;723;341;47.16;341;273;68;80.06
2275;Murten;6133;2444;39.85;2430;1792;638;73.74
2276;Ried bei Kerzers;774;316;40.83;314;204;110;64.97
2278;Ulmiz;347;100;28.82;100;67;33;67
2284;Mont-Vully;2659;997;37.5;985;707;278;71.78
2292;Brünisried;534;157;29.4;156;96;60;61.54
2293;Düdingen;5791;1981;34.21;1978;1420;558;71.79
2294;Giffers;1172;295;25.17;294;182;112;61.9
2295;Bösingen;2518;876;34.79;872;623;249;71.44
2296;Heitenried;1086;342;31.49;340;205;135;60.29
2299;Plaffeien;2776;653;23.52;651;421;230;64.67
2300;Plasselb;823;259;31.47;258;134;124;51.94
2301;Rechthalten;881;256;29.06;256;164;92;64.06
2303;St. Silvester;754;177;23.47;177;118;59;66.67
2304;St. Ursen;995;342;34.37;337;238;99;70.62
2305;Schmitten (FR);2902;1031;35.53;1029;765;264;74.34
2306;Tafers;5470;1851;33.84;1845;1296;549;70.24
2307;Tentlingen;995;283;28.44;282;199;83;70.57
2308;Ueberstorf;1859;614;33.03;609;385;224;63.22
2309;Wünnewil-Flamatt;3755;1205;32.09;1183;844;339;71.34
2321;Attalens;2306;678;29.4;667;544;123;81.56
2323;Bossonnens;899;261;29.03;258;214;44;82.95
2325;Châtel-Saint-Denis;3906;1202;30.77;1177;941;236;79.95
2328;Granges (Veveyse);575;250;43.48;249;210;39;84.34
2333;Remaufens;727;256;35.21;255;211;44;82.75
2335;Saint-Martin (FR);705;246;34.89;237;178;59;75.11
2336;Semsales;965;324;33.58;319;234;85;73.35
2337;Le Flon;814;258;31.7;253;192;61;75.89
2338;La Verrerie;794;236;29.72;231;166;65;71.86
9100;FR-CH de l'étranger;6040;1796;29.74;1782;1599;183;89.73
9102;FR-autres;...;...;...;...;...;...;...
2401;Egerkingen;2115;682;32.25;680;455;225;66.91
2402;Härkingen;1092;337;30.86;335;227;108;67.76
2403;Kestenholz;1351;512;37.9;510;339;171;66.47
2404;Neuendorf;1564;486;31.07;486;336;150;69.14
2405;Niederbuchsiten;849;246;28.98;243;137;106;56.38
2406;Oberbuchsiten;1413;442;31.28;439;288;151;65.6
2407;Oensingen;3512;1308;37.24;1299;826;473;63.59
2408;Wolfwil;1678;516;30.75;511;362;149;70.84
2421;Aedermannsdorf;447;182;40.72;182;109;73;59.89
2422;Balsthal;3465;1178;34;1175;828;347;70.47
2424;Herbetswil;429;139;32.4;138;79;59;57.25
2425;Holderbank (SO);499;157;31.46;157;74;83;47.13
2426;Laupersdorf;1304;428;32.82;426;275;151;64.55
2427;Matzendorf;1031;329;31.91;327;202;125;61.77
2428;Mümliswil-Ramiswil;1870;564;30.16;561;340;221;60.61
2430;Welschenrohr-Gänsbrunnen;907;329;36.27;328;196;132;59.76
2445;Biezwil;246;100;40.65;98;55;43;56.12
2455;Lüterkofen-Ichertswil;649;212;32.67;211;150;61;71.09
2456;Lüterswil-Gächliwil;260;121;46.54;121;73;48;60.33
2457;Messen;1133;370;32.66;369;223;146;60.43
2461;Schnottwil;899;308;34.26;307;202;105;65.8
2463;Unterramsern;175;66;37.71;66;41;25;62.12
2464;Lüsslingen-Nennigkofen;779;324;41.59;322;241;81;74.84
2465;Buchegg;2065;816;39.52;813;545;268;67.04
2471;Bättwil;832;294;35.34;291;196;95;67.35
2472;Büren (SO);735;273;37.14;273;177;96;64.84
2473;Dornach;4302;1828;42.49;1811;1321;490;72.94
2474;Gempen;570;256;44.91;254;167;87;65.75
2475;Hochwald;957;478;49.95;477;308;169;64.57
2476;Hofstetten-Flüh;2168;809;37.32;803;547;256;68.12
2477;Metzerlen-Mariastein;731;285;38.99;284;180;104;63.38
2478;Nuglar-St. Pantaleon;1166;414;35.51;412;278;134;67.48
2479;Rodersdorf;1019;507;49.75;501;397;104;79.24
2480;Seewen;828;287;34.66;287;194;93;67.6
2481;Witterswil;1044;411;39.37;409;297;112;72.62
2491;Hauenstein-Ifenthal;228;92;40.35;90;57;33;63.33
2492;Kienberg;399;143;35.84;142;82;60;57.75
2493;Lostorf;2911;1162;39.92;1154;748;406;64.82
2495;Niedergösgen;2322;1227;52.84;1213;813;400;67.02
2497;Obergösgen;1382;471;34.08;468;321;147;68.59
2499;Stüsslingen;903;347;38.43;340;208;132;61.18
2500;Trimbach;3569;1036;29.03;1034;780;254;75.44
2501;Winznau;1342;489;36.44;488;348;140;71.31
2502;Wisen (SO);329;131;39.82;131;88;43;67.18
2503;Erlinsbach (SO);2447;864;35.31;862;647;215;75.06
2511;Aeschi (SO);983;377;38.35;372;263;109;70.7
2513;Biberist;5456;1882;34.49;1871;1430;441;76.43
2514;Bolken;457;151;33.04;149;119;30;79.87
2516;Deitingen;1633;675;41.33;672;505;167;75.15
2517;Derendingen;3818;1023;26.79;1018;811;207;79.67
2518;Etziken;679;213;31.37;213;142;71;66.67
2519;Gerlafingen;2630;751;28.56;749;544;205;72.63
2520;Halten;681;256;37.59;255;179;76;70.2
2523;Horriwil;668;248;37.13;247;176;71;71.26
2524;Hüniken;111;59;53.15;59;50;9;84.75
2525;Kriegstetten;974;363;37.27;362;248;114;68.51
2526;Lohn-Ammannsegg;2168;872;40.22;868;637;231;73.39
2527;Luterbach;2410;853;35.39;847;648;199;76.51
2528;Obergerlafingen;887;272;30.67;272;179;93;65.81
2529;Oekingen;609;255;41.87;255;181;74;70.98
2530;Recherswil;1465;480;32.76;479;325;154;67.85
2532;Subingen;2194;735;33.5;733;524;209;71.49
2534;Zuchwil;4429;1316;29.71;1307;999;308;76.43
2535;Drei Höfe;591;242;40.95;240;163;77;67.92
2541;Balm bei Günsberg;161;76;47.2;74;43;31;58.11
2542;Bellach;3214;1423;44.28;1413;964;449;68.22
2543;Bettlach;3450;1055;30.58;1054;705;349;66.89
2544;Feldbrunnen-St. Niklaus;770;401;52.08;401;282;119;70.32
2545;Flumenthal;751;250;33.29;247;160;87;64.78
2546;Grenchen;9777;2725;27.87;2705;1843;862;68.13
2547;Günsberg;927;351;37.86;350;222;128;63.43
2548;Hubersdorf;581;200;34.42;200;138;62;69
2549;Kammersrohr;32;12;37.5;12;8;4;66.67
2550;Langendorf;2733;1036;37.91;1028;791;237;76.95
2551;Lommiswil;1172;479;40.87;478;321;157;67.15
2553;Oberdorf (SO);1301;552;42.43;552;421;131;76.27
2554;Riedholz;1702;630;37.02;626;453;173;72.36
2555;Rüttenen;1147;525;45.77;525;384;141;73.14
2556;Selzach;2436;729;29.93;727;512;215;70.43
2571;Boningen;546;165;30.22;164;100;64;60.98
2572;Däniken;1891;663;35.06;662;406;256;61.33
2573;Dulliken;2518;804;31.93;799;524;275;65.58
2574;Eppenberg-Wöschnau;198;66;33.33;64;39;25;60.94
2575;Fulenbach;1266;421;33.25;416;293;123;70.43
2576;Gretzenbach;1726;644;37.31;642;436;206;67.91
2578;Gunzgen;1189;347;29.18;347;205;142;59.08
2579;Hägendorf;3247;1108;34.12;1103;717;386;65
2580;Kappel (SO);2138;736;34.42;735;512;223;69.66
2581;Olten;11637;4398;37.79;4377;3425;952;78.25
2582;Rickenbach (SO);735;259;35.24;259;154;105;59.46
2583;Schönenwerd;2584;812;31.42;811;599;212;73.86
2584;Starrkirch-Wil;1244;591;47.51;590;428;162;72.54
2585;Walterswil (SO);558;144;25.81;144;84;60;58.33
2586;Wangen bei Olten;3248;1065;32.79;1065;765;300;71.83
2601;Solothurn;11712;4448;37.98;4427;3531;896;79.76
2611;Bärschwil;649;201;30.97;201;134;67;66.67
2612;Beinwil (SO);210;82;39.05;78;49;29;62.82
2613;Breitenbach;2447;788;32.2;776;532;244;68.56
2614;Büsserach;1641;501;30.53;499;323;176;64.73
2615;Erschwil;689;219;31.79;218;139;79;63.76
2616;Fehren;462;142;30.74;142;71;71;50
2617;Grindel;393;130;33.08;129;67;62;51.94
2618;Himmelried;704;258;36.65;258;164;94;63.57
2619;Kleinlützel;1018;303;29.76;301;201;100;66.78
2620;Meltingen;512;166;32.42;166;112;54;67.47
2621;Nunningen;1458;511;35.05;509;297;212;58.35
2622;Zullwil;475;137;28.84;135;64;71;47.41
9110;SO-Ausland-CH;...;...;...;...;...;...;...
9112;SO-Anderes;...;...;...;...;...;...;...
2701;Basel;91435;39610;43.32;39176;28582;10594;72.96
2702;Bettingen;717;369;51.46;367;211;156;57.49
2703;Riehen;13101;6514;49.72;6450;4239;2211;65.72
9120;BS-Ausland-CH;8384;2282;27.22;2269;1945;324;85.72
2761;Aesch (BL);6701;2118;31.61;2086;1421;665;68.12
2762;Allschwil;13081;4664;35.65;4478;3149;1329;70.32
2763;Arlesheim;6223;2620;42.1;2536;1933;603;76.22
2764;Biel-Benken;2411;968;40.15;953;636;317;66.74
2765;Binningen;9971;4145;41.57;4056;2805;1251;69.16
2766;Birsfelden;6443;1998;31.01;1944;1440;504;74.07
2767;Bottmingen;4152;1848;44.51;1793;1182;611;65.92
2768;Ettingen;3663;1375;37.54;1346;964;382;71.62
2769;Münchenstein;7760;2685;34.6;2672;1970;702;73.73
2770;Muttenz;12155;4471;36.78;4401;3214;1187;73.03
2771;Oberwil (BL);7376;2875;38.98;2792;1949;843;69.81
2772;Pfeffingen;1695;662;39.06;645;418;227;64.81
2773;Reinach (BL);12860;4852;37.73;4698;3234;1464;68.84
2774;Schönenbuch;1058;424;40.08;416;295;121;70.91
2775;Therwil;6902;2542;36.83;2463;1816;647;73.73
2781;Blauen;534;192;35.96;190;128;62;67.37
2782;Brislach;1206;328;27.2;322;207;115;64.29
2783;Burg im Leimental;197;66;33.5;65;35;30;53.85
2784;Dittingen;529;167;31.57;161;111;50;68.94
2785;Duggingen;1035;330;31.88;318;224;94;70.44
2786;Grellingen;1159;379;32.7;373;241;132;64.61
2787;Laufen;3558;1193;33.53;1171;839;332;71.65
2788;Liesberg;870;292;33.56;290;170;120;58.62
2789;Nenzlingen;326;100;30.67;100;68;32;68
2790;Roggenburg;220;59;26.82;57;25;32;43.86
2791;Röschenz;1394;472;33.86;465;302;163;64.95
2792;Wahlen;1067;299;28.02;296;204;92;68.92
2793;Zwingen;1455;348;23.92;338;232;106;68.64
2821;Arisdorf;1212;397;32.76;385;229;156;59.48
2822;Augst;705;257;36.45;254;175;79;68.9
2823;Bubendorf;3164;1087;34.36;1053;794;259;75.4
2824;Frenkendorf;3727;1175;31.53;1151;796;355;69.16
2825;Füllinsdorf;2822;976;34.59;958;606;352;63.26
2826;Giebenach;685;193;28.18;184;103;81;55.98
2827;Hersberg;244;81;33.2;79;45;34;56.96
2828;Lausen;3164;1049;33.15;1031;753;278;73.04
2829;Liestal;8918;3198;35.86;3140;2379;761;75.76
2830;Lupsingen;1034;397;38.39;387;283;104;73.13
2831;Pratteln;8422;2482;29.47;2424;1680;744;69.31
2832;Ramlinsburg;544;241;44.3;226;158;68;69.91
2833;Seltisberg;1028;448;43.58;440;321;119;72.95
2834;Ziefen;1114;420;37.7;412;300;112;72.82
2841;Anwil;428;166;38.79;165;111;54;67.27
2842;Böckten;579;239;41.28;236;165;71;69.92
2843;Buckten;495;191;38.59;191;104;87;54.45
2844;Buus;799;248;31.04;247;156;91;63.16
2845;Diepflingen;519;151;29.09;149;90;59;60.4
2846;Gelterkinden;4211;1386;32.91;1360;1008;352;74.12
2847;Häfelfingen;193;85;44.04;85;41;44;48.24
2848;Hemmiken;214;69;32.24;68;46;22;67.65
2849;Itingen;1372;481;35.06;476;350;126;73.53
2850;Känerkinden;410;144;35.12;144;91;53;63.19
2851;Kilchberg (BL);116;65;56.03;65;51;14;78.46
2852;Läufelfingen;955;327;34.24;322;183;139;56.83
2853;Maisprach;685;254;37.08;245;180;65;73.47
2854;Nusshof;197;59;29.95;58;43;15;74.14
2855;Oltingen;355;145;40.85;144;102;42;70.83
2856;Ormalingen;1646;529;32.14;525;380;145;72.38
2857;Rickenbach (BL);447;164;36.69;159;104;55;65.41
2858;Rothenfluh;594;173;29.12;171;117;54;68.42
2859;Rümlingen;260;87;33.46;86;50;36;58.14
2860;Rünenberg;601;258;42.93;252;167;85;66.27
2861;Sissach;4628;1684;36.39;1668;1213;455;72.72
2862;Tecknau;504;129;25.6;128;82;46;64.06
2863;Tenniken;687;201;29.26;197;140;57;71.07
2864;Thürnen;920;327;35.54;316;186;130;58.86
2865;Wenslingen;570;239;41.93;236;155;81;65.68
2866;Wintersingen;502;175;34.86;174;105;69;60.34
2867;Wittinsburg;316;138;43.67;134;90;44;67.16
2868;Zeglingen;387;132;34.11;130;99;31;76.15
2869;Zunzgen;1771;629;35.52;614;414;200;67.43
2881;Arboldswil;443;179;40.41;174;104;70;59.77
2882;Bennwil;492;186;37.8;177;124;53;70.06
2883;Bretzwil;594;178;29.97;178;105;73;58.99
2884;Diegten;1200;358;29.83;354;214;140;60.45
2885;Eptingen;389;130;33.42;125;62;63;49.6
2886;Hölstein;1696;593;34.96;576;393;183;68.23
2887;Lampenberg;379;167;44.06;167;115;52;68.86
2888;Langenbruck;701;224;31.95;222;149;73;67.12
2889;Lauwil;249;80;32.13;80;52;28;65
2890;Liedertswil;125;55;44;55;31;24;56.36
2891;Niederdorf;1185;308;25.99;305;206;99;67.54
2892;Oberdorf (BL);1598;436;27.28;429;288;141;67.13
2893;Reigoldswil;1167;347;29.73;336;231;105;68.75
2894;Titterten;317;125;39.43;119;83;36;69.75
2895;Waldenburg;711;168;23.63;163;96;67;58.9
9130;BL-Ausland-CH;...;...;...;...;...;...;...
2901;Gächlingen;644;429;66.61;405;276;129;68.15
2903;Löhningen;1024;628;61.33;594;395;199;66.5
2904;Neunkirch;1560;997;63.91;953;673;280;70.62
2914;Büttenhardt;299;152;50.84;147;100;47;68.03
2915;Dörflingen;684;449;65.64;429;266;163;62
2917;Lohn (SH);548;386;70.44;359;255;104;71.03
2919;Stetten (SH);873;591;67.7;540;375;165;69.44
2920;Thayngen;3398;2178;64.1;2055;1338;717;65.11
2931;Bargen (SH);228;151;66.23;141;81;60;57.45
2932;Beringen;3088;1894;61.33;1782;1172;610;65.77
2933;Buchberg;647;460;71.1;435;268;167;61.61
2936;Merishausen;581;383;65.92;368;224;144;60.87
2937;Neuhausen am Rheinfall;5374;2860;53.22;2679;1861;818;69.47
2938;Rüdlingen;560;393;70.18;379;239;140;63.06
2939;Schaffhausen;23000;13409;58.3;12522;9152;3370;73.09
2951;Beggingen;381;234;61.42;227;108;119;47.58
2952;Schleitheim;1227;720;58.68;683;394;289;57.69
2953;Siblingen;645;386;59.84;365;236;129;64.66
2961;Buch (SH);206;126;61.17;123;71;52;57.72
2962;Hemishofen;340;226;66.47;213;130;83;61.03
2963;Ramsen;932;544;58.37;518;310;208;59.85
2964;Stein am Rhein;2287;1345;58.81;1293;912;381;70.53
2971;Hallau;1544;863;55.89;841;514;327;61.12
2972;Oberhallau;342;215;62.87;210;112;98;53.33
2973;Trasadingen;385;236;61.3;227;109;118;48.02
2974;Wilchingen;1226;779;63.54;743;460;283;61.91
9140;SH-Ausland-CH;...;...;...;...;...;...;...
3001;Herisau;10486;3934;37.52;3919;2718;1201;69.35
3002;Hundwil;703;225;32.01;223;133;90;59.64
3003;Schönengrund;396;149;37.63;147;71;76;48.3
3004;Schwellbrunn;1192;464;38.93;458;250;208;54.59
3005;Stein (AR);1098;454;41.35;451;292;159;64.75
3006;Urnäsch;1677;546;32.56;544;324;220;59.56
3007;Waldstatt;1307;501;38.33;500;313;187;62.6
3021;Bühler;1113;422;37.92;418;242;176;57.89
3022;Gais;2271;948;41.74;940;653;287;69.47
3023;Speicher;3154;1347;42.71;1341;942;399;70.25
3024;Teufen (AR);4697;2075;44.18;2070;1439;631;69.52
3025;Trogen;1298;607;46.76;604;470;134;77.81
3031;Grub (AR);734;285;38.83;284;195;89;68.66
3032;Heiden;2820;1289;45.71;1274;934;340;73.31
3033;Lutzenberg;861;325;37.75;322;205;117;63.66
3034;Rehetobel;1299;547;42.11;545;397;148;72.84
3035;Reute (AR);524;216;41.22;216;135;81;62.5
3036;Wald (AR);653;268;41.04;267;189;78;70.79
3037;Walzenhausen;1293;446;34.49;446;295;151;66.14
3038;Wolfhalden;1299;449;34.57;444;283;161;63.74
9150;AR-Ausland-CH;...;...;...;...;...;...;...
3101;Appenzell;3842;1257;32.72;1220;795;425;65.16
3102;Gonten;1094;328;29.98;320;189;131;59.06
3104;Schlatt-Haslen;858;225;26.22;220;145;75;65.91
3111;Oberegg;1444;523;36.22;520;316;204;60.77
3112;Schwende-Rüte;4169;1274;30.56;1247;812;435;65.12
9160;AI-Ausland-CH;412;90;21.84;90;76;14;84.44
9161;AI-Korrespondenzweg;...;...;...;...;...;...;...
9162;AI-Anderes;...;...;...;...;...;...;...
3201;Häggenschwil;942;384;40.76;382;278;104;72.77
3202;Muolen;855;310;36.26;304;199;105;65.46
3203;St. Gallen;44627;17790;39.86;17647;13320;4327;75.48
3204;Wittenbach;5907;2792;47.27;2775;1985;790;71.53
3212;Eggersriet;1644;676;41.12;672;452;220;67.26
3441;Andwil (SG);1407;554;39.37;551;381;170;69.15
3442;Gaiserwald;5748;2360;41.06;2348;1639;709;69.8
3443;Gossau (SG);12100;4392;36.3;4377;3116;1261;71.19
3444;Waldkirch;2411;886;36.75;881;576;305;65.38
3211;Berg (SG);608;276;45.39;275;205;70;74.55
3213;Goldach;5755;2119;36.82;2114;1570;544;74.27
3214;Mörschwil;2599;1288;49.56;1281;912;369;71.19
3215;Rorschach;4163;1294;31.08;1285;1014;271;78.91
3216;Rorschacherberg;4447;1700;38.23;1686;1196;490;70.94
3217;Steinach;2265;735;32.45;731;547;184;74.83
3218;Tübach;978;392;40.08;392;282;110;71.94
3219;Untereggen;782;322;41.18;319;231;88;72.41
3237;Thal;4137;1496;36.16;1493;1046;447;70.06
3231;Au (SG);4139;1248;30.15;1239;951;288;76.76
3232;Balgach;3014;1065;35.34;1061;775;286;73.04
3233;Berneck;2543;921;36.22;917;679;238;74.05
3234;Diepoldsau;3881;1237;31.87;1234;939;295;76.09
3235;Rheineck;1926;856;44.44;853;586;267;68.7
3236;St. Margrethen;2543;744;29.26;741;475;266;64.1
3238;Widnau;5581;2036;36.48;2032;1551;481;76.33
3251;Altstätten;6975;2362;33.86;2352;1674;678;71.17
3252;Eichberg;1034;354;34.24;354;230;124;64.97
3253;Marbach (SG);1380;497;36.01;496;387;109;78.02
3254;Oberriet (SG);5841;1732;29.65;1727;1176;551;68.09
3255;Rebstein;2576;847;32.88;846;616;230;72.81
3256;Rüthi (SG);1457;469;32.19;466;321;145;68.88
3271;Buchs (SG);6453;2144;33.22;2137;1590;547;74.4
3272;Gams;2165;864;39.91;859;575;284;66.94
3273;Grabs;4607;2106;45.71;2097;1537;560;73.3
3274;Sennwald;3215;1041;32.38;1036;706;330;68.15
3275;Sevelen;2536;900;35.49;899;616;283;68.52
3276;Wartau;3007;1093;36.35;1087;729;358;67.07
3291;Bad Ragaz;3674;1361;37.04;1353;978;375;72.28
3292;Flums;3120;919;29.46;916;539;377;58.84
3293;Mels;5772;2522;43.69;2509;1778;731;70.86
3294;Pfäfers;1099;360;32.76;360;232;128;64.44
3295;Quarten;2015;738;36.63;736;441;295;59.92
3296;Sargans;3774;1278;33.86;1272;982;290;77.2
3297;Vilters-Wangs;3248;1293;39.81;1286;895;391;69.6
3298;Walenstadt;3694;1302;35.25;1299;876;423;67.44
3311;Amden;1366;481;35.21;481;336;145;69.85
3312;Benken (SG);2067;673;32.56;670;419;251;62.54
3313;Kaltbrunn;3060;884;28.89;872;553;319;63.42
3315;Schänis;2658;846;31.83;837;516;321;61.65
3316;Weesen;1215;432;35.56;431;314;117;72.85
3338;Schmerikon;2290;781;34.1;779;516;263;66.24
3339;Uznach;3779;1194;31.6;1190;870;320;73.11
3340;Rapperswil-Jona;18288;8227;44.99;8111;6240;1871;76.93
3341;Gommiswald;3690;1573;42.63;1559;955;604;61.26
3342;Eschenbach (SG);6489;2243;34.57;2227;1372;855;61.61
3352;Ebnat-Kappel;3489;1399;40.1;1391;929;462;66.79
3359;Wildhaus-Alt St. Johann;1862;825;44.31;821;540;281;65.77
3360;Nesslau;2693;974;36.17;963;623;340;64.69
3372;Hemberg;655;243;37.1;236;162;74;68.64
3374;Lichtensteig;1247;435;34.88;435;302;133;69.43
3375;Oberhelfenschwil;924;420;45.45;419;281;138;67.06
3396;Neckertal;2921;1023;35.02;1015;618;397;60.89
3379;Wattwil;5465;2037;37.27;2024;1418;606;70.06
3392;Kirchberg (SG);5130;1842;35.91;1830;1178;652;64.37
3393;Lütisburg;1055;391;37.06;391;263;128;67.26
3394;Mosnang;2113;712;33.7;708;433;275;61.16
3395;Bütschwil-Ganterschwil;3304;1097;33.2;1090;711;379;65.23
3401;Degersheim;2544;988;38.84;984;714;270;72.56
3402;Flawil;6084;2177;35.78;2166;1601;565;73.92
3405;Jonschwil;2560;904;35.31;898;579;319;64.48
3407;Oberuzwil;4142;1540;37.18;1536;1079;457;70.25
3408;Uzwil;7470;2481;33.21;2466;1737;729;70.44
3422;Niederbüren;1072;424;39.55;419;241;178;57.52
3423;Niederhelfenschwil;2206;777;35.22;773;525;248;67.92
3424;Oberbüren;3062;1069;34.91;1068;642;426;60.11
3426;Zuzwil (SG);3382;1396;41.28;1389;1009;380;72.64
3427;Wil (SG);14251;5487;38.5;5463;3997;1466;73.16
9170;SG-Ausland-CH;8147;2402;29.48;2395;2039;356;85.14
3506;Vaz/Obervaz;1831;662;36.16;642;443;199;69
3513;Lantsch/Lenz;389;141;36.25;140;101;39;72.14
3514;Schmitten (GR);186;69;37.1;68;43;25;63.24
3542;Albula/Alvra;982;309;31.47;298;198;100;66.44
3543;Surses;1781;522;29.31;509;369;140;72.5
3544;Bergün Filisur;657;248;37.75;241;169;72;70.12
3551;Brusio;890;351;39.44;349;282;67;80.8
3561;Poschiavo;2846;1785;62.72;1708;1335;373;78.16
3746;Zernez;1062;468;44.07;463;335;128;72.35
3752;Samnaun;520;154;29.62;154;119;35;77.27
3762;Scuol;3194;1251;39.17;1227;1037;190;84.52
3764;Valsot;688;176;25.58;173;143;30;82.66
3847;Val Müstair;1241;421;33.92;410;332;78;80.98
3721;Bonaduz;2328;741;31.83;730;598;132;81.92
3722;Domat/Ems;5175;1611;31.13;1585;1227;358;77.41
3723;Rhäzüns;959;344;35.87;344;269;75;78.2
3731;Felsberg;1792;623;34.77;617;477;140;77.31
3732;Flims;1916;757;39.51;747;537;210;71.89
3733;Tamins;878;335;38.15;332;248;84;74.7
3734;Trin;1054;416;39.47;408;326;82;79.9
3945;Trimmis;2390;893;37.36;865;571;294;66.01
3946;Untervaz;1822;507;27.83;494;373;121;75.51
3947;Zizers;2402;881;36.68;850;625;225;73.53
3951;Fläsch;603;212;35.16;210;143;67;68.1
3952;Jenins;663;245;36.95;238;174;64;73.11
3953;Maienfeld;2246;829;36.91;807;584;223;72.37
3954;Malans;1785;735;41.18;718;596;122;83.01
3955;Landquart;5861;1970;33.61;1909;1483;426;77.68
3781;Bever;447;184;41.16;184;141;43;76.63
3782;Celerina/Schlarigna;941;339;36.03;336;265;71;78.87
3783;Madulain;136;72;52.94;72;58;14;80.56
3784;Pontresina;1214;497;40.94;492;385;107;78.25
3785;La Punt Chamues-ch;477;170;35.64;166;122;44;73.49
3786;Samedan;1950;784;40.21;765;593;172;77.52
3787;St. Moritz;2528;1680;66.46;1633;1296;337;79.36
3788;S-chanf;486;172;35.39;170;118;52;69.41
3789;Sils im Engadin/Segl;418;176;42.11;173;132;41;76.3
3790;Silvaplana;646;219;33.9;216;165;51;76.39
3791;Zuoz;716;347;48.46;346;224;122;64.74
3792;Bregaglia;1205;491;40.75;475;366;109;77.05
3804;Buseno;69;37;53.62;36;30;6;83.33
3805;Castaneda;237;101;42.62;100;77;23;77
3808;Rossa;148;66;44.59;62;46;16;74.19
3810;Santa Maria in Calanca;96;26;27.08;26;25;1;96.15
3821;Lostallo;560;241;43.04;234;173;61;73.93
3822;Mesocco;951;382;40.17;373;298;75;79.89
3823;Soazza;248;108;43.55;103;77;26;74.76
3831;Cama;364;97;26.65;96;72;24;75
3832;Grono;842;299;35.51;289;233;56;80.62
3834;Roveredo (GR);1598;1193;74.66;1113;932;181;83.74
3835;San Vittore;573;231;40.31;224;181;43;80.8
3837;Calanca;195;71;36.41;70;47;23;67.14
3901;Chur;25973;9079;34.96;8894;7113;1781;79.98
3911;Churwalden;1389;518;37.29;504;353;151;70.04
3921;Arosa;2169;809;37.3;799;561;238;70.21
3932;Tschiertschen-Praden;243;73;30.04;73;44;29;60.27
3851;Davos;6868;3158;45.98;3109;2389;720;76.84
3861;Fideris;476;174;36.55;167;120;47;71.86
3862;Furna;155;51;32.9;50;35;15;70
3863;Jenaz;865;328;37.92;322;209;113;64.91
3871;Klosters;3151;1370;43.48;1335;952;383;71.31
3881;Conters im Prättigau;168;60;35.71;60;39;21;65
3882;Küblis;592;175;29.56;172;127;45;73.84
3891;Luzein;1229;424;34.5;415;287;128;69.16
3961;Grüsch;1570;578;36.82;564;413;151;73.23
3962;Schiers;1858;613;32.99;596;446;150;74.83
3972;Seewis im Prättigau;1024;313;30.57;308;228;80;74.03
3572;Falera;457;203;44.42;201;142;59;70.65
3575;Laax;1234;457;37.03;444;318;126;71.62
3581;Sagogn;520;176;33.85;175;134;41;76.57
3582;Schluein;395;100;25.32;98;69;29;70.41
3603;Vals;732;233;31.83;232;194;38;83.62
3618;Lumnezia;1739;558;32.09;549;411;138;74.86
3619;Ilanz/Glion;3396;1060;31.21;1026;750;276;73.1
3672;Safiental;736;276;37.5;269;196;73;72.86
3981;Breil/Brigels;1425;400;28.07;392;286;106;72.96
3982;Disentis/Mustér;1543;579;37.52;571;424;147;74.26
3983;Medel (Lucmagn);342;119;34.8;118;98;20;83.05
3985;Sumvitg;1016;376;37.01;373;275;98;73.73
3986;Tujetsch;974;324;33.26;315;213;102;67.62
3987;Trun;982;281;28.62;275;186;89;67.64
3988;Obersaxen Mundaun;921;317;34.42;311;194;117;62.38
3633;Fürstenau;249;87;34.94;85;65;20;76.47
3637;Rothenbrunnen;216;88;40.74;85;64;21;75.29
3638;Scharans;658;259;39.36;255;182;73;71.37
3640;Sils im Domleschg;647;189;29.21;182;116;66;63.74
3661;Cazis;1557;471;30.25;466;329;137;70.6
3662;Flerden;173;58;33.53;58;47;11;81.03
3663;Masein;381;146;38.32;144;113;31;78.47
3668;Thusis;1913;519;27.13;504;369;135;73.21
3669;Tschappina;101;48;47.52;46;30;16;65.22
3670;Urmein;115;53;46.09;52;40;12;76.92
3673;Domleschg;1578;622;39.42;603;471;132;78.11
3681;Avers;147;69;46.94;68;46;22;67.65
3695;Sufers;100;56;56;54;39;15;72.22
3701;Andeer;680;285;41.91;275;186;89;67.64
3711;Rongellen;39;23;58.97;23;12;11;52.17
3712;Zillis-Reischen;279;107;38.35;105;64;41;60.95
3713;Ferrera;66;23;34.85;23;12;11;52.17
3714;Rheinwald;460;211;45.87;207;145;62;70.05
3715;Muntogna da Schons;291;126;43.3;124;77;47;62.1
9180;GR-Ausland-CH;...;...;...;...;...;...;...
9182;GR-Anderes;...;...;...;...;...;...;...
4001;Aarau;14211;6196;43.6;6152;4736;1416;76.98
4002;Biberstein;1191;538;45.17;532;394;138;74.06
4003;Buchs (AG);4252;1513;35.58;1507;1141;366;75.71
4004;Densbüren;559;199;35.6;198;118;80;59.6
4005;Erlinsbach (AG);2856;1243;43.52;1235;885;350;71.66
4006;Gränichen;4996;1711;34.25;1696;1203;493;70.93
4007;Hirschthal;1135;394;34.71;391;252;139;64.45
4008;Küttigen;4237;1832;43.24;1821;1401;420;76.94
4009;Muhen;2702;936;34.64;935;636;299;68.02
4010;Oberentfelden;4794;1540;32.12;1531;1034;497;67.54
4012;Suhr;5545;1965;35.44;1957;1513;444;77.31
4013;Unterentfelden;2440;988;40.49;985;728;257;73.91
4021;Baden;11742;4902;41.75;4880;3837;1043;78.63
4022;Bellikon;1161;477;41.09;473;314;159;66.38
4023;Bergdietikon;1885;774;41.06;771;433;338;56.16
4024;Birmenstorf (AG);1942;747;38.47;742;504;238;67.92
4026;Ennetbaden;2202;1091;49.55;1085;883;202;81.38
4027;Fislisbach;3415;1160;33.97;1153;837;316;72.59
4028;Freienwil;713;299;41.94;299;217;82;72.58
4029;Gebenstorf;3282;1202;36.62;1198;887;311;74.04
4030;Killwangen;1188;400;33.67;395;271;124;68.61
4031;Künten;1192;395;33.14;395;251;144;63.54
4032;Mägenwil;1303;422;32.39;421;295;126;70.07
4033;Mellingen;3009;905;30.08;902;609;293;67.52
4034;Neuenhof;3758;1041;27.7;1040;773;267;74.33
4035;Niederrohrdorf;2672;1010;37.8;1001;743;258;74.23
4037;Oberrohrdorf;2816;1298;46.09;1294;915;379;70.71
4038;Obersiggenthal;4814;2136;44.37;2103;1599;504;76.03
4039;Remetschwil;1417;541;38.18;539;360;179;66.79
4040;Spreitenbach;4651;1064;22.88;1047;694;353;66.28
4041;Stetten (AG);1353;419;30.97;418;287;131;68.66
4042;Turgi;1543;467;30.27;465;351;114;75.48
4044;Untersiggenthal;4213;1608;38.17;1596;1138;458;71.3
4045;Wettingen;12538;4882;38.94;4856;3651;1205;75.19
4046;Wohlenschwil;1026;361;35.19;358;271;87;75.7
4047;Würenlingen;2804;1003;35.77;1001;648;353;64.74
4048;Würenlos;4219;1645;38.99;1637;1129;508;68.97
4049;Ehrendingen;3180;1137;35.75;1135;790;345;69.6
4061;Arni (AG);1283;531;41.39;530;360;170;67.92
4062;Berikon;3153;1244;39.45;1240;801;439;64.6
4063;Bremgarten (AG);5100;1652;32.39;1646;1126;520;68.41
4064;Büttikon;657;226;34.4;224;144;80;64.29
4065;Dottikon;2022;644;31.85;642;448;194;69.78
4066;Eggenwil;684;287;41.96;286;189;97;66.08
4067;Fischbach-Göslikon;1085;366;33.73;362;240;122;66.3
4068;Hägglingen;1692;619;36.58;613;425;188;69.33
4071;Jonen;1392;545;39.15;542;391;151;72.14
4072;Niederwil (AG);1906;637;33.42;633;379;254;59.87
4073;Oberlunkhofen;1443;619;42.9;611;409;202;66.94
4074;Oberwil-Lieli;1718;800;46.57;793;479;314;60.4
4075;Rudolfstetten-Friedlisberg;2625;904;34.44;897;593;304;66.11
4076;Sarmenstorf;1953;681;34.87;681;405;276;59.47
4077;Tägerig;958;342;35.7;340;228;112;67.06
4078;Uezwil;357;108;30.25;106;68;38;64.15
4079;Unterlunkhofen;1031;393;38.12;390;245;145;62.82
4080;Villmergen;4100;1228;29.95;1223;758;465;61.98
4081;Widen;2542;1123;44.18;1118;738;380;66.01
4082;Wohlen (AG);8359;2975;35.59;2962;1998;964;67.45
4083;Zufikon;2942;1143;38.85;1137;746;391;65.61
4084;Islisberg;437;184;42.11;183;113;70;61.75
4091;Auenstein;1152;462;40.1;461;319;142;69.2
4092;Birr;1918;580;30.24;577;356;221;61.7
4093;Birrhard;533;196;36.77;194;125;69;64.43
4095;Brugg;7525;3299;43.84;3286;2449;837;74.53
4099;Habsburg;335;177;52.84;171;114;57;66.67
4100;Hausen (AG);2253;862;38.26;862;598;264;69.37
4104;Lupfig;2108;808;38.33;804;557;247;69.28
4105;Mandach;238;102;42.86;102;55;47;53.92
4106;Mönthal;300;119;39.67;119;65;54;54.62
4107;Mülligen;736;255;34.65;255;180;75;70.59
4110;Remigen;745;337;45.23;334;225;109;67.37
4111;Riniken;983;423;43.03;422;298;124;70.62
4112;Rüfenach;636;279;43.87;277;186;91;67.15
4117;Thalheim (AG);631;251;39.78;248;134;114;54.03
4120;Veltheim (AG);992;344;34.68;341;228;113;66.86
4121;Villigen;1267;516;40.73;515;347;168;67.38
4122;Villnachern;1104;500;45.29;494;345;149;69.84
4123;Windisch;4429;1732;39.11;1727;1366;361;79.1
4124;Bözberg;1177;480;40.78;479;294;185;61.38
4125;Schinznach;1574;608;38.63;606;401;205;66.17
4131;Beinwil am See;2295;918;40;915;676;239;73.88
4132;Birrwil;879;374;42.55;372;255;117;68.55
4133;Burg (AG);561;186;33.16;185;109;76;58.92
4134;Dürrenäsch;881;292;33.14;288;147;141;51.04
4135;Gontenschwil;1469;426;29;422;231;191;54.74
4136;Holziken;967;263;27.2;261;151;110;57.85
4137;Leimbach (AG);326;128;39.26;126;74;52;58.73
4138;Leutwil;589;250;42.44;250;130;120;52
4139;Menziken;3166;940;29.69;932;610;322;65.45
4140;Oberkulm;1718;587;34.17;583;376;207;64.49
4141;Reinach (AG);4333;1328;30.65;1315;863;452;65.63
4142;Schlossrued;637;206;32.34;204;115;89;56.37
4143;Schmiedrued;877;253;28.85;248;151;97;60.89
4144;Schöftland;3050;1072;35.15;1064;745;319;70.02
4145;Teufenthal (AG);1052;342;32.51;342;203;139;59.36
4146;Unterkulm;1809;567;31.34;563;386;177;68.56
4147;Zetzwil;939;313;33.33;313;209;104;66.77
4161;Eiken;1489;444;29.82;440;293;147;66.59
4163;Frick;3353;1206;35.97;1199;851;348;70.98
4164;Gansingen;770;277;35.97;275;179;96;65.09
4165;Gipf-Oberfrick;2500;952;38.08;949;709;240;74.71
4186;ch-Ueken;1654;585;35.36880290205563;578;358;220;61.93771626297578
4166;ch;1053;394;37.42;388;232;156;59.79
4169;Kaisten;1810;569;31.44;565;409;156;72.39
4170;Laufenburg;1962;733;37.36;722;501;221;69.39
4172;Münchwilen (AG);562;207;36.83;206;131;75;63.59
4173;Oberhof;406;154;37.93;154;85;69;55.19
4175;Oeschgen;694;230;33.14;227;133;94;58.59
4176;Schwaderloch;426;129;30.28;127;69;58;54.33
4177;Sisseln;989;226;22.85;223;149;74;66.82
4179;Ueken;601;191;31.78;190;126;64;66.32
4181;Wittnau;954;373;39.1;372;237;135;63.71
4182;Wölflinswil;754;287;38.06;284;162;122;57.04
4183;Zeihen;794;293;36.9;293;189;104;64.51
4184;Mettauertal;1447;458;31.65;453;295;158;65.12
4185;Böztal;1800;669;37.17;666;421;245;63.21
4191;Ammerswil;474;160;33.76;160;112;48;70
4192;Boniswil;994;380;38.23;380;255;125;67.11
4193;Brunegg;534;147;27.53;145;89;56;61.38
4194;Dintikon;1324;485;36.63;483;331;152;68.53
4195;Egliswil;1034;376;36.36;375;252;123;67.2
4196;Fahrwangen;1329;372;27.99;372;252;120;67.74
4197;Hallwil;600;170;28.33;168;103;65;61.31
4198;Hendschiken;833;215;25.81;214;126;88;58.88
4199;Holderbank (AG);736;209;28.4;208;120;88;57.69
4200;Hunzenschwil;2346;622;26.51;619;398;221;64.3
4201;Lenzburg;6368;2438;38.29;2427;1901;526;78.33
4202;Meisterschwanden;2081;794;38.15;787;538;249;68.36
4203;Möriken-Wildegg;2809;1115;39.69;1115;807;308;72.38
4204;Niederlenz;2677;880;32.87;875;673;202;76.91
4205;Othmarsingen;1721;550;31.96;545;398;147;73.03
4206;Rupperswil;3440;1122;32.62;1115;782;333;70.13
4207;Schafisheim;1964;730;37.17;724;518;206;71.55
4208;Seengen;2796;1151;41.17;1147;745;402;64.95
4209;Seon;3208;1105;34.45;1099;742;357;67.52
4210;Staufen;2203;920;41.76;916;702;214;76.64
4221;Abtwil;648;225;34.72;225;142;83;63.11
4222;Aristau;1009;303;30.03;300;216;84;72
4223;Auw;1278;384;30.05;383;257;126;67.1
4224;Beinwil (Freiamt);808;307;38;307;188;119;61.24
4226;Besenbüren;428;149;34.81;147;83;64;56.46
4227;Bettwil;452;189;41.81;188;108;80;57.45
4228;Boswil;1846;577;31.26;576;359;217;62.33
4229;Bünzen;733;258;35.2;258;169;89;65.5
4230;Buttwil;861;337;39.14;333;232;101;69.67
4231;Dietwil;875;273;31.2;272;178;94;65.44
4232;Geltwil;147;61;41.5;61;38;23;62.3
4233;Kallern;264;98;37.12;97;54;43;55.67
4234;Merenschwand;2292;801;34.95;798;543;255;68.05
4235;Mühlau;781;260;33.29;257;155;102;60.31
4236;Muri (AG);4948;1648;33.31;1639;1154;485;70.41
4237;Oberrüti;1035;367;35.46;361;285;76;78.95
4238;Rottenschwil;605;223;36.86;220;137;83;62.27
4239;Sins;2746;969;35.29;960;650;310;67.71
4240;Waltenschwil;2035;691;33.96;687;499;188;72.63
4251;Hellikon;605;202;33.39;202;105;97;51.98
4252;Kaiseraugst;3249;1144;35.21;1137;783;354;68.87
4253;Magden;2657;1061;39.93;1053;759;294;72.08
4254;Möhlin;6680;1870;27.99;1864;1325;539;71.08
4255;Mumpf;845;233;27.57;229;143;86;62.45
4256;Obermumpf;759;228;30.04;228;144;84;63.16
4257;Olsberg;268;125;46.64;124;84;40;67.74
4258;Rheinfelden;7653;2643;34.54;2628;2012;616;76.56
4259;Schupfart;581;212;36.49;212;121;91;57.08
4260;Stein (AG);1578;442;28.01;441;292;149;66.21
4261;Wallbach;1365;418;30.62;413;260;153;62.95
4262;Wegenstetten;776;251;32.35;249;163;86;65.46
4263;Zeiningen;1591;517;32.5;510;339;171;66.47
4264;Zuzgen;635;214;33.7;211;153;58;72.51
4271;Aarburg;3840;1126;29.32;1116;797;319;71.42
4273;Bottenwil;598;212;35.45;212;151;61;71.23
4274;Brittnau;2874;919;31.98;913;608;305;66.59
4275;Kirchleerau;614;234;38.11;234;132;102;56.41
4276;Kölliken;2835;892;31.46;884;613;271;69.34
4277;Moosleerau;645;238;36.9;236;134;102;56.78
4279;Murgenthal;1998;589;29.48;586;374;212;63.82
4280;Oftringen;7242;1842;25.43;1830;1321;509;72.19
4281;Reitnau;1097;537;48.95;531;312;219;58.76
4282;Rothrist;5710;1502;26.3;1496;1045;451;69.85
4283;Safenwil;2461;690;28.04;683;419;264;61.35
4284;Staffelbach;897;250;27.87;250;153;97;61.2
4285;Strengelbach;2970;956;32.19;950;732;218;77.05
4286;Uerkheim;1021;336;32.91;335;203;132;60.6
4287;Vordemwald;1463;493;33.7;491;339;152;69.04
4288;Wiliberg;139;68;48.92;68;34;34;50
4289;Zofingen;7879;3142;39.88;3124;2358;766;75.48
4303;Böttstein;2014;726;36.05;725;501;224;69.1
4304;Döttingen;1952;676;34.63;673;432;241;64.19
4305;Endingen;1627;594;36.51;588;397;191;67.52
4306;Fisibach;264;122;46.21;120;85;35;70.83
4307;Full-Reuenthal;581;221;38.04;221;159;62;71.95
4309;Klingnau;2068;766;37.04;764;504;260;65.97
4310;Koblenz;813;239;29.4;237;152;85;64.14
4311;Leibstadt;746;267;35.79;267;146;121;54.68
4312;Lengnau (AG);1862;726;38.99;725;451;274;62.21
4313;Leuggern;1448;586;40.47;581;382;199;65.75
4314;Mellikon;153;88;57.52;87;60;27;68.97
4318;Schneisingen;1076;427;39.68;427;279;148;65.34
4319;Siglistorf;398;129;32.41;127;72;55;56.69
4320;Tegerfelden;800;288;36;288;172;116;59.72
4324;Zurzach;4194;1528;36.43;1516;1020;496;67.28
9190;AG-Ausland-CH;9720;2292;23.58;2283;2022;261;88.57
4401;Arbon;8164;3413;41.81;3328;2407;921;72.33
4406;Dozwil;462;202;43.72;195;135;60;69.23
4411;Egnach;3230;1477;45.73;1429;1034;395;72.36
4416;Hefenhofen;842;271;32.19;270;188;82;69.63
4421;Horn;1931;708;36.66;698;500;198;71.63
4426;Kesswil;651;289;44.39;287;216;71;75.26
4431;Roggwil (TG);2118;731;34.51;707;495;212;70.01
4436;Romanshorn;6454;2177;33.73;2127;1577;550;74.14
4441;Salmsach;830;259;31.2;255;185;70;72.55
4446;Sommeri;390;135;34.62;134;98;36;73.13
4451;Uttwil;1240;479;38.63;470;313;157;66.6
4461;Amriswil;7553;2255;29.86;2222;1593;629;71.69
4536;Basadingen-Schlattingen;1271;453;35.64;437;283;154;64.76
4545;Diessenhofen;2176;720;33.09;711;522;189;73.42
4546;Schlatt (TG);1227;375;30.56;361;239;122;66.2
4561;Felben-Wellhausen;1831;544;29.71;537;342;195;63.69
4566;Frauenfeld;16137;5925;36.72;5794;4131;1663;71.3
4571;Gachnang;2941;1250;42.5;1233;894;339;72.51
4590;Hüttlingen;599;252;42.07;246;167;79;67.89
4591;Matzingen;1749;528;30.19;519;351;168;67.63
4601;Neunforn;788;331;42.01;317;192;125;60.57
4606;Stettfurt;860;364;42.33;358;250;108;69.83
4611;Thundorf;1041;413;39.67;400;251;149;62.75
4616;Uesslingen-Buch;828;311;37.56;300;194;106;64.67
4621;Warth-Weiningen;975;410;42.05;400;261;139;65.25
4801;Berlingen;583;328;56.26;328;222;106;67.68
4806;Eschenz;1152;480;41.67;465;284;181;61.08
4811;Herdern;793;389;49.05;376;260;116;69.15
4816;Homburg;1105;453;41;437;262;175;59.95
4821;Hüttwilen;1211;529;43.68;518;344;174;66.41
4826;Mammern;388;169;43.56;168;94;74;55.95
4831;Müllheim;1988;635;31.94;625;399;226;63.84
4841;Pfyn;1358;477;35.13;472;302;170;63.98
4864;Steckborn;2331;864;37.07;836;583;253;69.74
4871;Wagenhausen;1090;418;38.35;404;270;134;66.83
4641;Altnau;1413;516;36.52;510;394;116;77.25
4643;Bottighofen;1233;561;45.5;548;411;137;75
4646;Ermatingen;1973;751;38.06;735;491;244;66.8
4651;Gottlieben;162;89;54.94;87;69;18;79.31
4656;Güttingen;1020;405;39.71;395;255;140;64.56
4666;Kemmental;1673;558;33.35;551;383;168;69.51
4671;Kreuzlingen;8463;2712;32.05;2635;2427;208;92.11
4681;Langrickenbach;863;315;36.5;312;217;95;69.55
4683;Lengwil;998;321;32.16;310;240;70;77.42
4691;Münsterlingen;1766;738;41.79;722;529;193;73.27
4696;Tägerwilen;2398;793;33.07;762;590;172;77.43
4701;Wäldi;700;283;40.43;279;171;108;61.29
4846;Raperswilen;299;148;49.5;146;64;82;43.84
4851;Salenstein;783;402;51.34;398;243;155;61.06
4551;Aadorf;6144;2159;35.14;2109;1522;587;72.17
4716;Bettwiesen;788;243;30.84;234;150;84;64.1
4721;Bichelsee-Balterswil;1997;627;31.4;615;429;186;69.76
4723;Braunau;555;217;39.1;210;136;74;64.76
4724;Eschlikon;3019;1574;52.14;1551;1077;474;69.44
4726;Fischingen;2038;719;35.28;701;448;253;63.91
4741;Lommis;859;303;35.27;297;178;119;59.93
4746;Münchwilen (TG);3490;1012;29;989;670;319;67.75
4751;Rickenbach (TG);1468;498;33.92;494;343;151;69.43
4761;Sirnach;4861;1553;31.95;1503;1012;491;67.33
4776;Tobel-Tägerschen;1079;353;32.72;341;216;125;63.34
4781;Wängi;3202;1054;32.92;1021;667;354;65.33
4786;Wilen (TG);1671;585;35.01;572;449;123;78.5
4471;Bischofszell;3622;1165;32.16;1139;854;285;74.98
4476;Erlen;2122;682;32.14;670;461;209;68.81
4486;Hauptwil-Gottshaus;1377;449;32.61;441;290;151;65.76
4495;Hohentannen;445;142;31.91;139;96;43;69.06
4501;Kradolf-Schönenberg;2226;740;33.24;729;521;208;71.47
4506;Sulgen;2366;792;33.47;775;552;223;71.23
4511;Zihlschlacht-Sitterdorf;1612;528;32.75;523;397;126;75.91
4711;Affeltrangen;1678;561;33.43;545;336;209;61.65
4756;Schönholzerswilen;594;209;35.19;206;117;89;56.8
4791;Wuppenau;775;327;42.19;319;207;112;64.89
4881;Amlikon-Bissegg;996;387;38.86;384;260;124;67.71
4891;Berg (TG);2279;791;34.71;767;558;209;72.75
4901;Birwinken;946;373;39.43;364;252;112;69.23
4911;Bürglen (TG);2273;666;29.3;648;435;213;67.13
4921;Bussnang;1589;620;39.02;617;400;217;64.83
4941;Märstetten;1986;665;33.48;659;452;207;68.59
4946;Weinfelden;7490;2656;35.46;2588;1885;703;72.84
4951;Wigoltingen;1635;527;32.23;508;332;176;65.35
9200;TG-Ausland-CH;3649;1006;27.57;1003;864;139;86.14
5001;Arbedo-Castione;2981;1203;40.36;1179;924;255;78.37
5002;Bellinzona;26799;10339;38.58;10040;8057;1983;80.25
5003;Cadenazzo;1386;473;34.13;464;318;146;68.53
5009;Isone;306;109;35.62;106;74;32;69.81
5010;Lumino;1007;473;46.97;462;361;101;78.14
5017;Sant'Antonino;1519;573;37.72;563;402;161;71.4
5048;Acquarossa;1455;519;35.67;500;351;149;70.2
5049;Blenio;1459;513;35.16;493;321;172;65.11
5050;Serravalle;1852;703;37.96;675;510;165;75.56
5061;Airolo;1001;476;47.55;470;329;141;70
5063;Bedretto;104;47;45.19;44;33;11;75
5064;Bodio;440;169;38.41;166;119;47;71.69
5071;Dalpe;158;77;48.73;77;60;17;77.92
5072;Faido;2125;877;41.27;853;651;202;76.32
5073;Giornico;532;166;31.2;161;126;35;78.26
5076;Personico;239;102;42.68;101;80;21;79.21
5077;Pollegio;439;171;38.95;168;127;41;75.6
5078;Prato (Leventina);274;147;53.65;144;130;14;90.28
5079;Quinto;703;309;43.95;299;231;68;77.26
5091;Ascona;3551;1490;41.96;1458;1067;391;73.18
5096;Brione sopra Minusio;362;161;44.48;157;92;65;58.6
5097;Brissago;1308;504;38.53;485;333;152;68.66
5108;Gordola;3176;1190;37.47;1174;810;364;68.99
5112;Lavertezzo;801;280;34.96;276;194;82;70.29
5113;Locarno;9518;3294;34.61;3226;2456;770;76.13
5115;Losone;4410;1702;38.59;1660;1238;422;74.58
5117;Mergoscia;186;84;45.16;83;64;19;77.11
5118;Minusio;4824;2071;42.93;2031;1500;531;73.86
5120;Muralto;1791;722;40.31;714;503;211;70.45
5121;Orselina;559;260;46.51;256;189;67;73.83
5125;Ronco sopra Ascona;440;188;42.73;179;110;69;61.45
5131;Tenero-Contra;1967;753;38.28;737;524;213;71.1
5136;Onsernone;804;262;32.59;253;197;56;77.87
5138;Cugnasco-Gerra;1984;817;41.18;801;622;179;77.65
5396;Terre di Pedemonte;1909;903;47.3;878;657;221;74.83
5397;Centovalli;966;334;34.58;327;242;85;74.01
5398;Gambarogno;3605;1300;36.06;1273;955;318;75.02
5399;Verzasca;602;207;34.39;202;138;64;68.32
5141;Agno;2526;972;38.48;958;725;233;75.68
5143;Aranno;263;127;48.29;123;99;24;80.49
5144;Arogno;756;298;39.42;293;213;80;72.7
5146;Astano;259;109;42.08;107;80;27;74.77
5148;Bedano;1029;444;43.15;441;320;121;72.56
5149;Bedigliora;516;196;37.98;191;154;37;80.63
5151;Bioggio;1794;855;47.66;837;647;190;77.3
5154;Bissone;497;213;42.86;206;158;48;76.7
5160;Brusino Arsizio;360;150;41.67;145;97;48;66.9
5161;Cademario;542;223;41.14;222;158;64;71.17
5162;Cadempino;929;399;42.95;393;292;101;74.3
5167;Canobbio;1392;612;43.97;589;433;156;73.51
5171;Caslano;2642;1135;42.96;1112;825;287;74.19
5176;Comano;1442;791;54.85;767;581;186;75.75
5180;Cureglia;982;496;50.51;491;367;124;74.75
5181;Curio;438;194;44.29;188;150;38;79.79
5186;Grancia;305;130;42.62;125;87;38;69.6
5187;Gravesano;911;403;44.24;396;290;106;73.23
5189;Lamone;930;359;38.6;354;260;94;73.45
5192;Lugano;34497;13998;40.58;13544;9912;3632;73.18
5193;Magliaso;1077;489;45.4;474;356;118;75.11
5194;Manno;892;455;51.01;445;339;106;76.18
5196;Massagno;3218;1339;41.61;1322;1065;257;80.56
5198;Melide;978;408;41.72;397;296;101;74.56
5199;Mezzovico-Vira;929;411;44.24;404;278;126;68.81
5200;Miglieglia;203;67;33;64;48;16;75
5203;Morcote;414;191;46.14;187;61;126;32.62
5205;Muzzano;594;286;48.15;278;211;67;75.9
5206;Neggio;267;149;55.81;146;104;42;71.23
5207;Novaggio;652;268;41.1;260;196;64;75.38
5208;Origlio;1002;483;48.2;473;367;106;77.59
5210;Paradiso;1628;620;38.08;608;443;165;72.86
5212;Ponte Capriasca;1321;628;47.54;618;479;139;77.51
5214;Porza;1036;512;49.42;505;392;113;77.62
5216;Pura;936;426;45.51;417;328;89;78.66
5221;Savosa;1265;580;45.85;570;416;154;72.98
5225;Sorengo;1039;524;50.43;520;415;105;79.81
5226;Capriasca;5009;2187;43.66;2134;1691;443;79.24
5227;Torricella-Taverne;1809;774;42.79;759;557;202;73.39
5230;Vernate;415;189;45.54;187;141;46;75.4
5231;Vezia;1213;538;44.35;525;418;107;79.62
5233;Vico Morcote;191;85;44.5;84;74;10;88.1
5236;Collina d'Oro;2758;1298;47.06;1275;971;304;76.16
5237;Alto Malcantone;1087;498;45.81;492;377;115;76.63
5238;Monteceneri;2975;1072;36.03;1048;799;249;76.24
5239;Tresa;2258;913;40.43;897;625;272;69.68
5240;Val Mara;1796;750;41.76;729;535;194;73.39
5242;Balerna;2162;880;40.7;869;663;206;76.29
5249;Castel San Pietro;1658;765;46.14;748;559;189;74.73
5250;Chiasso;4422;1647;37.25;1617;1179;438;72.91
5251;Coldrerio;2108;926;43.93;907;667;240;73.54
5254;Mendrisio;10281;4368;42.49;4279;3210;1069;75.02
5257;Morbio Inferiore;2975;1244;41.82;1221;928;293;76
5260;Novazzano;1784;832;46.64;811;555;256;68.43
5263;Riva San Vitale;1870;800;42.78;781;567;214;72.6
5266;Stabio;3014;1185;39.32;1162;856;306;73.67
5268;Vacallo;2125;975;45.88;963;732;231;76.01
5269;Breggia;1605;668;41.62;658;474;184;72.04
5281;Biasca;3300;1163;35.24;1148;919;229;80.05
5287;Riviera;2404;814;33.86;783;593;190;75.73
5304;Bosco/Gurin;45;11;24.44;11;7;4;63.64
5307;Campo (Vallemaggia);57;19;33.33;19;17;2;89.47
5309;Cerentino;46;16;34.78;16;14;2;87.5
5310;Cevio;858;304;35.43;298;225;73;75.5
5315;Linescio;42;17;40.48;17;14;3;82.35
5317;Maggia;1910;703;36.81;685;499;186;72.85
5323;Lavizzara;433;178;41.11;174;101;73;58.05
5324;Avegno Gordevio;1090;430;39.45;410;299;111;72.93
9210;TI-CH-all'estero;...;...;...;...;...;...;...
9211;TI-voto per corrispondenza;...;...;...;...;...;...;...
9212;TI-altri;...;...;...;...;...;...;...
5401;Aigle;4888;1612;32.98;1598;1376;222;86.11
5402;Bex;4257;1415;33.24;1404;1225;179;87.25
5403;Chessel;283;108;38.16;107;89;18;83.18
5404;Corbeyrier;312;155;49.68;152;131;21;86.18
5405;Gryon;770;334;43.38;333;282;51;84.68
5406;Lavey-Morcles;610;229;37.54;227;201;26;88.55
5407;Leysin;1421;543;38.21;542;504;38;92.99
5408;Noville;622;205;32.96;205;167;38;81.46
5409;Ollon;4059;1667;41.07;1651;1426;225;86.37
5410;Ormont-Dessous;790;270;34.18;268;215;53;80.22
5411;Ormont-Dessus;927;485;52.32;473;405;68;85.62
5412;Rennaz;453;118;26.05;118;104;14;88.14
5413;Roche (VD);883;250;28.31;244;194;50;79.51
5414;Villeneuve (VD);2745;870;31.69;866;743;123;85.8
5415;Yvorne;714;279;39.08;277;247;30;89.17
5451;Avenches;2204;740;33.58;733;630;103;85.95
5456;Cudrefin;1086;429;39.5;421;356;65;84.56
5458;Faoug;595;213;35.8;207;170;37;82.13
5464;Vully-les-Lacs;2150;814;37.86;783;635;148;81.1
5663;Bussy-sur-Moudon;152;65;42.76;63;45;18;71.43
5665;Chavannes-sur-Moudon;157;82;52.23;81;60;21;74.07
5669;Curtilles;221;71;32.13;70;62;8;88.57
5671;Dompierre (VD);187;89;47.59;88;68;20;77.27
5673;Hermenches;248;108;43.55;107;84;23;78.5
5674;Lovatens;116;43;37.07;42;38;4;90.48
5675;Lucens;2105;721;34.25;715;586;129;81.96
5678;Moudon;2603;797;30.62;787;638;149;81.07
5683;Prévonloup;130;52;40;51;40;11;78.43
5684;Rossenges;45;22;48.89;21;12;9;57.14
5688;Syens;93;40;43.01;38;27;11;71.05
5690;Villars-le-Comte;105;40;38.1;40;33;7;82.5
5692;Vucherens;381;165;43.31;163;144;19;88.34
5785;Corcelles-le-Jorat;300;160;53.33;158;120;38;75.95
5798;Ropraz;305;132;43.28;131;117;14;89.31
5803;Vulliens;387;189;48.84;186;153;33;82.26
5812;Champtauroz;93;44;47.31;43;38;5;88.37
5813;Chevroux;361;142;39.34;142;121;21;85.21
5816;Corcelles-près-Payerne;1421;507;35.68;502;441;61;87.85
5817;Grandcour;607;260;42.83;249;190;59;76.31
5819;Henniez;204;53;25.98;52;42;10;80.77
5821;Missy;253;121;47.83;119;100;19;84.03
5822;Payerne;4797;1479;30.83;1468;1278;190;87.06
5827;Trey;182;84;46.15;81;65;16;80.25
5828;Treytorrens (Payerne);81;47;58.02;47;34;13;72.34
5830;Villarzel;299;130;43.48;123;98;25;79.67
5831;Valbroye;1909;728;38.14;712;575;137;80.76
5471;Bettens;359;127;35.38;125;107;18;85.6
5472;Bournens;246;103;41.87;101;82;19;81.19
5473;Boussens;634;242;38.17;241;208;33;86.31
5480;Daillens;657;269;40.94;269;219;50;81.41
5487;Lussery-Villars;300;126;42;120;107;13;89.17
5489;Mex (VD);447;187;41.83;183;156;27;85.25
5495;Penthalaz;1886;678;35.95;670;579;91;86.42
5496;Penthaz;1039;379;36.48;373;315;58;84.45
5501;Sullens;697;265;38.02;259;223;36;86.1
5503;Vufflens-la-Ville;853;392;45.96;388;348;40;89.69
5511;Assens;1023;417;40.76;412;347;65;84.22
5512;Bercher;789;303;38.4;300;251;49;83.67
5514;Bottens;846;304;35.93;302;247;55;81.79
5515;Bretigny-sur-Morrens;533;218;40.9;216;168;48;77.78
5516;Cugy (VD);1582;709;44.82;704;624;80;88.64
5518;Echallens;3544;1231;34.73;1219;1050;169;86.14
5520;Essertines-sur-Yverdon;661;252;38.12;248;219;29;88.31
5521;Etagnières;691;262;37.92;260;217;43;83.46
5522;Fey;471;193;40.98;190;160;30;84.21
5523;Froideville;1583;628;39.67;620;502;118;80.97
5527;Morrens (VD);728;275;37.77;272;237;35;87.13
5529;Oulens-sous-Echallens;403;174;43.18;173;140;33;80.92
5530;Pailly;371;174;46.9;171;136;35;79.53
5531;Penthéréaz;306;114;37.25;113;96;17;84.96
5533;Poliez-Pittet;556;204;36.69;201;166;35;82.59
5534;Rueyres;166;88;53.01;84;73;11;86.9
5535;Saint-Barthélemy (VD);522;189;36.21;183;158;25;86.34
5537;Villars-le-Terroir;789;291;36.88;285;228;57;80
5539;Vuarrens;608;204;33.55;202;168;34;83.17
5540;Montilliez;1147;439;38.27;438;373;65;85.16
5541;Goumoëns;752;307;40.82;304;261;43;85.86
5661;Boulens;270;105;38.89;102;77;25;75.49
5680;Ogens;183;65;35.52;64;49;15;76.56
5693;Montanaire;1800;707;39.28;700;567;133;81
5804;Jorat-Menthue;1042;408;39.16;399;306;93;76.69
5923;Oppens;120;55;45.83;55;38;17;69.09
5551;Bonvillars;366;160;43.72;158;137;21;86.71
5552;Bullet;517;210;40.62;208;167;41;80.29
5553;Champagne;666;244;36.64;240;205;35;85.42
5554;Concise;639;276;43.19;272;221;51;81.25
5555;Corcelles-près-Concise;270;116;42.96;116;93;23;80.17
5556;Fiez;298;132;44.3;130;114;16;87.69
5557;Fontaines-sur-Grandson;141;41;29.08;41;32;9;78.05
5559;Giez;292;119;40.75;117;103;14;88.03
5560;Grandevent;165;79;47.88;78;73;5;93.59
5561;Grandson;2163;758;35.04;751;643;108;85.62
5562;Mauborget;89;60;67.42;59;43;16;72.88
5563;Mutrux;111;39;35.14;38;35;3;92.11
5564;Novalles;73;34;46.58;34;25;9;73.53
5565;Onnens (VD);337;146;43.32;146;133;13;91.1
5566;Provence;287;110;38.33;108;76;32;70.37
5568;Sainte-Croix;3219;1161;36.07;1147;987;160;86.05
5571;Tévenon;587;240;40.89;238;204;34;85.71
5741;L'Abergement;185;94;50.81;94;88;6;93.62
5742;Agiez;222;98;44.14;98;80;18;81.63
5743;Arnex-sur-Orbe;447;197;44.07;193;153;40;79.27
5744;Ballaigues;711;255;35.86;253;227;26;89.72
5745;Baulmes;701;265;37.8;264;233;31;88.26
5746;Bavois;619;229;37;226;194;32;85.84
5747;Bofflens;150;79;52.67;78;58;20;74.36
5748;Bretonnières;185;98;52.97;97;79;18;81.44
5749;Chavornay;2936;993;33.82;984;869;115;88.31
5750;Les Clées;131;55;41.98;53;47;6;88.68
5752;Croy;293;119;40.61;118;105;13;88.98
5754;Juriens;244;95;38.93;93;69;24;74.19
5755;Lignerolle;290;113;38.97;111;84;27;75.68
5756;Montcherand;333;128;38.44;121;106;15;87.6
5757;Orbe;3697;1240;33.54;1233;1096;137;88.89
5758;La Praz;128;71;55.47;68;52;16;76.47
5759;Premier;157;94;59.87;94;74;20;78.72
5760;Rances;335;203;60.6;199;152;47;76.38
5761;Romainmôtier-Envy;366;211;57.65;206;173;33;83.98
5762;Sergey;98;58;59.18;56;43;13;76.79
5763;Valeyres-sous-Rances;387;158;40.83;157;113;44;71.97
5764;Vallorbe;2114;683;32.31;677;551;126;81.39
5765;Vaulion;352;153;43.47;153;125;28;81.7
5766;Vuiteboeuf;363;146;40.22;144;133;11;92.36
5871;L'Abbaye;1037;392;37.8;390;337;53;86.41
5872;Le Chenit;2734;1017;37.2;1001;868;133;86.71
5873;Le Lieu;602;252;41.86;239;208;31;87.03
5902;Belmont-sur-Yverdon;248;91;36.69;90;74;16;82.22
5903;Bioley-Magnoux;174;99;56.9;99;66;33;66.67
5904;Chamblon;394;171;43.4;168;147;21;87.5
5905;Champvent;428;170;39.72;170;146;24;85.88
5907;Chavannes-le-Chêne;213;106;49.77;103;84;19;81.55
5908;Chêne-Pâquier;93;39;41.94;39;29;10;74.36
5909;Cheseaux-Noréaz;484;225;46.49;224;196;28;87.5
5910;Cronay;279;134;48.03;133;113;20;84.96
5911;Cuarny;181;79;43.65;78;63;15;80.77
5912;Démoret;118;60;50.85;60;47;13;78.33
5913;Donneloye;544;240;44.12;233;185;48;79.4
5914;Ependes (VD);242;95;39.26;94;81;13;86.17
5919;Mathod;426;164;38.5;160;138;22;86.25
5921;Molondin;160;85;53.13;79;65;14;82.28
5922;Montagny-près-Yverdon;489;185;37.83;185;151;34;81.62
5924;Orges;224;86;38.39;83;77;6;92.77
5925;Orzens;155;92;59.35;89;78;11;87.64
5926;Pomy;547;249;45.52;243;203;40;83.54
5928;Rovray;111;66;59.46;63;47;16;74.6
5929;Suchy;384;157;40.89;156;127;29;81.41
5930;Suscévaz;143;74;51.75;72;53;19;73.61
5931;Treycovagnes;320;114;35.63;111;99;12;89.19
5932;Ursins;152;74;48.68;72;50;22;69.44
5933;Valeyres-sous-Montagny;490;174;35.51;174;161;13;92.53
5934;Valeyres-sous-Ursins;185;101;54.59;96;84;12;87.5
5935;Villars-Epeney;72;35;48.61;35;30;5;85.71
5937;Vugelles-La Mothe;85;28;32.94;28;24;4;85.71
5938;Yverdon-les-Bains;15315;5420;35.39;5373;4810;563;89.52
5939;Yvonand;2309;836;36.21;829;718;111;86.61
5582;Cheseaux-sur-Lausanne;2698;1026;38.03;1022;873;149;85.42
5584;Epalinges;5312;2220;41.79;2201;1881;320;85.46
5585;Jouxtens-Mézery;916;452;49.34;442;384;58;86.88
5586;Lausanne;64740;23159;35.77;22928;20269;2659;88.4
5587;Le Mont-sur-Lausanne;4739;1864;39.33;1846;1544;302;83.64
5592;Romanel-sur-Lausanne;2045;727;35.55;719;599;120;83.31
5581;Belmont-sur-Lausanne;2214;995;44.94;982;805;177;81.98
5588;Paudex;878;355;40.43;346;299;47;86.42
5590;Pully;10366;4572;44.11;4525;3811;714;84.22
5601;Chexbres;1384;604;43.64;600;510;90;85
5604;Forel (Lavaux);1338;553;41.33;547;435;112;79.52
5606;Lutry;6256;2673;42.73;2643;2229;414;84.34
5607;Puidoux;1566;720;45.98;712;587;125;82.44
5609;Rivaz;264;122;46.21;121;99;22;81.82
5610;Saint-Saphorin (Lavaux);238;115;48.32;115;100;15;86.96
5611;Savigny;2092;972;46.46;961;781;180;81.27
5613;Bourg-en-Lavaux;3459;1649;47.67;1637;1367;270;83.51
5790;Maracon;336;162;48.21;158;130;28;82.28
5792;Montpreveyres;378;150;39.68;150;130;20;86.67
5799;Servion;1295;524;40.46;521;452;69;86.76
5805;Oron;3550;1305;36.76;1285;1094;191;85.14
5806;Jorat-Mézières;1851;802;43.33;786;646;140;82.19
5422;Aubonne;2056;888;43.19;879;773;106;87.94
5423;Ballens;330;148;44.85;145;121;24;83.45
5424;Berolle;199;91;45.73;89;72;17;80.9
5425;Bière;903;338;37.43;334;279;55;83.53
5426;Bougy-Villars;270;110;40.74;107;89;18;83.18
5427;Féchy;486;225;46.3;223;200;23;89.69
5428;Gimel;1235;486;39.35;478;386;92;80.75
5431;Mollens (VD);210;78;37.14;73;56;17;76.71
5435;Saint-Livres;466;188;40.34;186;155;31;83.33
5436;Saint-Oyens;251;115;45.82;114;92;22;80.7
5437;Saubraz;228;93;40.79;92;75;17;81.52
5474;La Chaux (Cossonay);280;124;44.29;123;111;12;90.24
5475;Chavannes-le-Veyron;100;78;78;78;71;7;91.03
5476;Chevilly;206;94;45.63;93;81;12;87.1
5477;Cossonay;2331;914;39.21;901;779;122;86.46
5479;Cuarnens;327;159;48.62;156;109;47;69.87
5481;Dizy;159;84;52.83;79;71;8;89.87
5482;Eclépens;718;281;39.14;279;249;30;89.25
5483;Ferreyres;214;115;53.74;113;90;23;79.65
5484;Gollion;606;242;39.93;240;202;38;84.17
5485;Grancy;259;124;47.88;124;103;21;83.06
5486;L'Isle;726;265;36.5;257;212;45;82.49
5488;Mauraz;46;29;63.04;28;22;6;78.57
5490;Moiry;230;135;58.7;133;112;21;84.21
5491;Mont-la-Ville;310;124;40;121;91;30;75.21
5492;Montricher;642;293;45.64;293;229;64;78.16
5493;Orny;239;87;36.4;86;74;12;86.05
5497;Pompaples;495;183;36.97;180;152;28;84.44
5498;La Sarraz;1467;523;35.65;513;452;61;88.11
5499;Senarclens;321;127;39.56;123;103;20;83.74
5621;Aclens;324;144;44.44;142;120;22;84.51
5622;Bremblens;364;162;44.51;160;138;22;86.25
5623;Buchillon;405;183;45.19;181;156;25;86.19
5628;Chigny;197;93;47.21;92;77;15;83.7
5629;Clarmont;123;60;48.78;60;51;9;85
5631;Denens;507;239;47.14;237;207;30;87.34
5632;Denges;902;377;41.8;373;336;37;90.08
5633;Echandens;1569;718;45.76;699;615;84;87.98
5634;Echichens;1934;855;44.21;845;735;110;86.98
5636;Etoy;1513;633;41.84;625;549;76;87.84
5637;Lavigny;530;238;44.91;235;197;38;83.83
5638;Lonay;1566;652;41.63;637;571;66;89.64
5639;Lully (VD);511;221;43.25;219;198;21;90.41
5640;Lussy-sur-Morges;439;200;45.56;198;180;18;90.91
5642;Morges;8458;3383;40;3332;2890;442;86.73
5643;Préverenges;2861;1106;38.66;1091;949;142;86.98
5645;Romanel-sur-Morges;339;143;42.18;143;115;28;80.42
5646;Saint-Prex;2823;1100;38.97;1090;967;123;88.72
5649;Tolochenaz;1077;401;37.23;393;324;69;82.44
5650;Vaux-sur-Morges;128;74;57.81;72;59;13;81.94
5652;Villars-sous-Yens;410;179;43.66;178;158;20;88.76
5653;Vufflens-le-Château;562;255;45.37;255;220;35;86.27
5654;Vullierens;347;150;43.23;148;125;23;84.46
5655;Yens;845;388;45.92;384;343;41;89.32
5656;Hautemorges;2668;1207;45.24;1197;1008;189;84.21
5851;Allaman;254;109;42.91;107;97;10;90.65
5429;Longirod;313;140;44.73;139;114;25;82.01
5430;Marchissy;304;151;49.67;149;127;22;85.23
5434;Saint-George;628;258;41.08;257;219;38;85.21
5701;Arnex-sur-Nyon;129;60;46.51;60;53;7;88.33
5702;Arzier-Le Muids;1504;675;44.88;668;562;106;84.13
5703;Bassins;812;342;42.12;340;283;57;83.24
5704;Begnins;1098;453;41.26;450;398;52;88.44
5705;Bogis-Bossey;447;189;42.28;185;171;14;92.43
5706;Borex;624;311;49.84;311;271;40;87.14
5707;Chavannes-de-Bogis;635;283;44.57;280;225;55;80.36
5708;Chavannes-des-Bois;423;164;38.77;162;139;23;85.8
5709;Chéserex;769;363;47.2;359;294;65;81.89
5710;Coinsins;323;134;41.49;133;106;27;79.7
5711;Commugny;1383;625;45.19;621;526;95;84.7
5712;Coppet;1493;642;43;638;561;77;87.93
5713;Crans (VD);1160;536;46.21;529;452;77;85.44
5714;Crassier;647;297;45.9;293;267;26;91.13
5715;Duillier;661;305;46.14;293;265;28;90.44
5716;Eysins;833;318;38.18;313;274;39;87.54
5717;Founex;1654;670;40.51;663;572;91;86.27
5718;Genolier;1075;503;46.79;499;433;66;86.77
5719;Gingins;702;308;43.87;305;253;52;82.95
5720;Givrins;583;287;49.23;283;253;30;89.4
5721;Gland;6695;2403;35.89;2382;2128;254;89.34
5722;Grens;235;112;47.66;112;96;16;85.71
5723;Mies;968;407;42.05;406;358;48;88.18
5724;Nyon;10244;3923;38.3;3885;3467;418;89.24
5725;Prangins;2289;1045;45.65;1036;909;127;87.74
5726;La Rippe;669;280;41.85;278;244;34;87.77
5727;Saint-Cergue;1463;483;33.01;478;424;54;88.7
5728;Signy-Avenex;322;159;49.38;156;132;24;84.62
5729;Tannay;789;394;49.94;385;344;41;89.35
5730;Trélex;840;405;48.21;405;366;39;90.37
5731;Le Vaud;809;345;42.65;341;284;57;83.28
5732;Vich;541;196;36.23;195;178;17;91.28
5852;Bursinel;277;123;44.4;123;107;16;86.99
5853;Bursins;475;222;46.74;216;189;27;87.5
5854;Burtigny;226;102;45.13;98;83;15;84.69
5855;Dully;318;154;48.43;151;128;23;84.77
5856;Essertines-sur-Rolle;393;181;46.06;177;160;17;90.4
5857;Gilly;727;336;46.22;335;282;53;84.18
5858;Luins;321;133;41.43;130;114;16;87.69
5859;Mont-sur-Rolle;1448;584;40.33;584;504;80;86.3
5860;Perroy;819;349;42.61;348;302;46;86.78
5861;Rolle;2719;930;34.2;928;823;105;88.69
5862;Tartegnin;140;61;43.57;60;42;18;70
5863;Vinzel;238;124;52.1;123;105;18;85.37
5583;Crissier;3498;1253;35.82;1235;1054;181;85.34
5589;Prilly;5843;2146;36.73;2107;1827;280;86.71
5591;Renens (VD);8297;2391;28.82;2366;2100;266;88.76
5624;Bussigny;4446;2066;46.47;2052;1739;313;84.75
5627;Chavannes-près-Renens;2929;867;29.6;849;744;105;87.63
5635;Ecublens (VD);5490;1869;34.04;1850;1555;295;84.05
5648;Saint-Sulpice (VD);2029;953;46.97;947;794;153;83.84
5651;Villars-Sainte-Croix;557;222;39.86;217;182;35;83.87
5841;Château-d'Oex;2028;696;34.32;683;566;117;82.87
5842;Rossinière;362;129;35.64;128;109;19;85.16
5843;Rougemont;476;144;30.25;143;114;29;79.72
5882;Chardonne;1872;850;45.41;841;733;108;87.16
5883;Corseaux;1442;666;46.19;660;569;91;86.21
5884;Corsier-sur-Vevey;1892;748;39.53;744;636;108;85.48
5885;Jongny;938;403;42.96;398;344;54;86.43
5886;Montreux;12094;4089;33.81;4054;3533;521;87.15
5889;La Tour-de-Peilz;6745;2810;41.66;2774;2456;318;88.54
5890;Vevey;9243;3202;34.64;3178;2834;344;89.18
5891;Veytaux;500;193;38.6;192;169;23;88.02
5892;Blonay - Saint-Légier;6910;2954;42.75;2936;2551;385;86.89
9220;VD-CH de l'étranger;18675;4525;24.23;4506;4040;466;89.66
9222;VD-autres;...;...;...;...;...;...;...
6002;Brig-Glis;9192;3026;32.92;2976;2251;725;75.64
6004;Eggerberg;283;81;28.62;80;50;30;62.5
6007;Naters;7153;2443;34.15;2395;1644;751;68.64
6008;Ried-Brig;1522;538;35.35;529;369;160;69.75
6009;Simplon;262;87;33.21;86;59;27;68.6
6010;Termen;698;246;35.24;244;174;70;71.31
6011;Zwischbergen;54;31;57.41;29;5;24;17.24
6021;Ardon;1728;614;35.53;603;465;138;77.11
6022;Chamoson;2524;994;39.38;965;671;294;69.53
6023;Conthey;5433;1687;31.05;1633;1303;330;79.79
6024;Nendaz;4648;1429;30.74;1381;971;410;70.31
6025;Vétroz;3663;1268;34.62;1224;1005;219;82.11
6032;Bourg-Saint-Pierre;148;72;48.65;72;33;39;45.83
6033;Liddes;555;189;34.05;187;87;100;46.52
6034;Orsières;2153;934;43.38;906;554;352;61.15
6035;Sembrancher;684;227;33.19;222;125;97;56.31
6037;Val de Bagnes;5836;2114;36.22;2058;1558;500;75.7
6052;Bellwald;274;104;37.96;103;75;28;72.82
6054;Binn;106;28;26.42;28;16;12;57.14
6056;Ernen;403;157;38.96;155;120;35;77.42
6057;Fiesch;692;236;34.1;231;161;70;69.7
6058;Fieschertal;224;82;36.61;81;49;32;60.49
6061;Lax;221;96;43.44;96;78;18;81.25
6076;Obergoms;501;200;39.92;191;145;46;75.92
6077;Goms;957;409;42.74;398;283;115;71.11
6082;Ayent;2878;1146;39.82;1115;797;318;71.48
6083;Evolène;1289;533;41.35;523;348;175;66.54
6084;Hérémence;1133;560;49.43;553;362;191;65.46
6087;Saint-Martin (VS);662;300;45.32;296;216;80;72.97
6089;Vex;1300;528;40.62;511;364;147;71.23
6090;Mont-Noble;839;413;49.23;404;289;115;71.53
6101;Agarn;569;199;34.97;197;123;74;62.44
6102;Albinen;195;75;38.46;75;50;25;66.67
6104;Ergisch;157;88;56.05;88;37;51;42.05
6109;Inden;68;26;38.24;25;15;10;60
6110;Leuk;2876;1229;42.73;1210;829;381;68.51
6111;Leukerbad;788;258;32.74;258;187;71;72.48
6112;Oberems;106;30;28.3;30;21;9;70
6113;Salgesch;1099;455;41.4;451;316;135;70.07
6116;Varen;495;157;31.72;157;106;51;67.52
6117;Guttet-Feschel;335;94;28.06;93;50;43;53.76
6118;Gampel-Bratsch;1456;577;39.63;571;375;196;65.67
6119;Turtmann-Unterems;832;280;33.65;273;186;87;68.13
6131;Bovernier;606;243;40.1;238;136;102;57.14
6133;Fully;5597;2019;36.07;1961;1526;435;77.82
6134;Isérables;667;217;32.53;208;144;64;69.23
6135;Leytron;2206;938;42.52;914;678;236;74.18
6136;Martigny;11304;4221;37.34;4093;3289;804;80.36
6137;Martigny-Combe;1613;594;36.83;580;450;130;77.59
6139;Riddes;1795;689;38.38;668;481;187;72.01
6140;Saillon;1630;574;35.21;564;418;146;74.11
6141;Saxon;3247;1025;31.57;991;702;289;70.84
6142;Trient;113;58;51.33;58;38;20;65.52
6151;Champéry;851;358;42.07;343;253;90;73.76
6152;Collombey-Muraz;5530;1618;29.26;1575;1214;361;77.08
6153;Monthey;9809;3466;35.33;3362;2619;743;77.9
6154;Port-Valais;2267;706;31.14;696;546;150;78.45
6155;Saint-Gingolph;604;212;35.1;207;157;50;75.85
6156;Troistorrents;3242;1168;36.03;1127;823;304;73.03
6157;Val-d'Illiez;1314;529;40.26;502;335;167;66.73
6158;Vionnaz;1740;632;36.32;610;481;129;78.85
6159;Vouvry;2375;789;33.22;776;569;207;73.32
6172;Bister;29;12;41.38;12;7;5;58.33
6173;Bitsch;716;208;29.05;208;141;67;67.79
6177;Grengiols;340;85;25;82;64;18;78.05
6181;Riederalp;323;148;45.82;147;108;39;73.47
6191;Ausserberg;487;232;47.64;229;146;83;63.76
6192;Blatten;243;108;44.44;107;56;51;52.34
6193;Bürchen;592;200;33.78;198;133;65;67.17
6194;Eischoll;375;132;35.2;132;79;53;59.85
6195;Ferden;215;76;35.35;76;48;28;63.16
6197;Kippel;281;112;39.86;110;71;39;64.55
6198;Niedergesteln;542;167;30.81;167;99;68;59.28
6199;Raron;1365;469;34.36;465;336;129;72.26
6201;Unterbäch;347;114;32.85;114;77;37;67.54
6202;Wiler (Lötschen);422;145;34.36;144;101;43;70.14
6203;Mörel-Filet;507;201;39.64;198;165;33;83.33
6204;Steg-Hohtenn;1162;462;39.76;457;287;170;62.8
6205;Bettmeralp;335;93;27.76;90;70;20;77.78
6211;Collonges;517;164;31.72;161;129;32;80.12
6212;Dorénaz;623;193;30.98;191;105;86;54.97
6213;Evionnaz;818;298;36.43;294;225;69;76.53
6214;Finhaut;234;89;38.03;87;72;15;82.76
6215;Massongex;1175;426;36.26;412;309;103;75
6217;Saint-Maurice;2638;1050;39.8;1023;818;205;79.96
6218;Salvan;1064;448;42.11;439;338;101;76.99
6219;Vernayaz;1175;423;36;412;317;95;76.94
6220;Vérossaz;530;214;40.38;211;154;57;72.99
6232;Chalais;2339;911;38.95;892;688;204;77.13
6235;Chippis;747;288;38.55;286;239;47;83.57
6238;Grône;1557;525;33.72;507;371;136;73.18
6239;Icogne;392;147;37.5;147;117;30;79.59
6240;Lens;2442;949;38.86;917;690;227;75.25
6246;Saint-Léonard;1606;642;39.98;625;429;196;68.64
6248;Sierre;9573;3618;37.79;3503;2768;735;79.02
6252;Anniviers;1839;803;43.67;785;571;214;72.74
6253;Crans-Montana;5514;2143;38.86;2114;1641;473;77.63
6254;Noble-Contrée;3085;1261;40.88;1246;995;251;79.86
6261;Arbaz;900;365;40.56;363;256;107;70.52
6263;Grimisuat;2270;926;40.79;904;692;212;76.55
6265;Savièse;5423;2138;39.42;2122;1538;584;72.48
6266;Sion;20719;7519;36.29;7347;5768;1579;78.51
6267;Veysonnaz;406;122;30.05;119;94;25;78.99
6281;Baltschieder;951;280;29.44;279;199;80;71.33
6282;Eisten;180;68;37.78;68;37;31;54.41
6283;Embd;244;76;31.15;76;42;34;55.26
6285;Grächen;962;260;27.03;258;151;107;58.53
6286;Lalden;492;162;32.93;162;119;43;73.46
6287;Randa;268;103;38.43;100;70;30;70
6288;Saas-Almagell;285;96;33.68;95;64;31;67.37
6289;Saas-Balen;267;79;29.59;78;47;31;60.26
6290;Saas-Fee;928;340;36.64;334;278;56;83.23
6291;Saas-Grund;768;219;28.52;218;149;69;68.35
6292;St. Niklaus;1639;430;26.24;426;239;187;56.1
6293;Stalden (VS);874;322;36.84;311;208;103;66.88
6294;Staldenried;450;191;42.44;187;123;64;65.78
6295;Täsch;481;129;26.82;128;84;44;65.63
6296;Törbel;398;116;29.15;115;69;46;60
6297;Visp;5140;1504;29.26;1462;1063;399;72.71
6298;Visperterminen;1062;375;35.31;368;276;92;75
6299;Zeneggen;216;72;33.33;71;57;14;80.28
6300;Zermatt;2901;902;31.09;880;617;263;70.11
9230;VS-CH de l'étranger;5804;1456;25.09;1364;1193;171;87.46
9232;VS-autres;...;...;...;...;...;...;...
6404;Boudry;3587;1060;29.55;1042;860;182;82.53
6408;Cortaillod;3152;1106;35.09;1089;900;189;82.64
6413;Rochefort;975;399;40.92;394;324;70;82.23
6416;Milvignes;6046;2244;37.12;2222;1824;398;82.09
6417;La Grande Béroche;6041;2149;35.57;2132;1752;380;82.18
6421;La Chaux-de-Fonds;22587;6702;29.67;6619;5597;1022;84.56
6422;Les Planchettes;167;56;33.53;56;40;16;71.43
6423;La Sagne;873;328;37.57;325;247;78;76
6432;La Brévine;516;223;43.22;219;151;68;68.95
6433;Brot-Plamboz;202;89;44.06;86;60;26;69.77
6434;Le Cerneux-Péquignot;263;101;38.4;99;78;21;78.79
6435;La Chaux-du-Milieu;358;127;35.47;124;98;26;79.03
6436;Le Locle;7300;2391;32.75;2362;1950;412;82.56
6437;Les Ponts-de-Martel;992;440;44.35;434;306;128;70.51
6451;Cornaux;1021;352;34.48;349;257;92;73.64
6452;Cressier (NE);1157;435;37.6;431;352;79;81.67
6453;Enges;194;96;49.48;94;78;16;82.98
6454;Hauterive (NE);1666;709;42.56;701;571;130;81.46
6455;Le Landeron;3133;1030;32.88;1025;861;164;84
6456;Lignières;674;260;38.58;254;201;53;79.13
6458;Neuchâtel;26475;9346;35.3;9261;7831;1430;84.56
6459;Saint-Blaise;2140;814;38.04;807;674;133;83.52
6461;La Tène;3076;1047;34.04;1038;884;154;85.16
6487;Val-de-Ruz;11443;4054;35.43;4009;3155;854;78.7
6504;La Côte-aux-Fées;371;169;45.55;167;118;49;70.66
6511;Les Verrières;566;139;24.56;137;108;29;78.83
6512;Val-de-Travers;7546;2115;28.03;2082;1621;461;77.86
9240;NE-CH de l'étranger;...;...;...;...;...;...;...
6601;Aire-la-Ville;714;373;52.24;365;284;81;77.81
6602;Anières;1330;713;53.61;710;537;173;75.63
6603;Avully;1098;457;41.62;446;365;81;81.84
6604;Avusy;999;461;46.15;449;371;78;82.63
6605;Bardonnex;1407;676;48.05;666;581;85;87.24
6606;Bellevue;1574;599;38.06;591;489;102;82.74
6607;Bernex;6279;2788;44.4;2764;2306;458;83.43
6608;Carouge (GE);11137;4527;40.65;4463;3814;649;85.46
6609;Cartigny;616;329;53.41;323;269;54;83.28
6610;Céligny;423;193;45.63;190;149;41;78.42
6611;Chancy;950;343;36.11;333;257;76;77.18
6612;Chêne-Bougeries;6426;2933;45.64;2897;2430;467;83.88
6613;Chêne-Bourg;4384;1738;39.64;1713;1422;291;83.01
6614;Choulex;704;385;54.69;380;315;65;82.89
6615;Collex-Bossy;896;462;51.56;448;361;87;80.58
6616;Collonge-Bellerive;4571;2208;48.3;2193;1736;457;79.16
6617;Cologny;2852;1299;45.55;1288;1025;263;79.58
6618;Confignon;2941;1410;47.94;1392;1207;185;86.71
6619;Corsier (GE);1185;580;48.95;578;478;100;82.7
6620;Dardagny;1030;422;40.97;415;315;100;75.9
6621;Genève;85725;34686;40.46;34265;28671;5594;83.67
6622;Genthod;1486;704;47.38;700;573;127;81.86
6623;Le Grand-Saconnex;5333;2011;37.71;1997;1626;371;81.42
6624;Gy;296;162;54.73;160;131;29;81.88
6625;Hermance;577;288;49.91;284;232;52;81.69
6626;Jussy;793;375;47.29;367;282;85;76.84
6627;Laconnex;485;256;52.78;248;207;41;83.47
6628;Lancy;16351;5991;36.64;5906;4843;1063;82
6629;Meinier;1321;693;52.46;681;555;126;81.5
6630;Meyrin;10958;3908;35.66;3868;3082;786;79.68
6631;Onex;9640;3634;37.7;3564;2856;708;80.13
6632;Perly-Certoux;1812;812;44.81;797;667;130;83.69
6633;Plan-les-Ouates;6280;2587;41.19;2565;2203;362;85.89
6634;Pregny-Chambésy;1497;682;45.56;672;549;123;81.7
6635;Presinge;460;239;51.96;236;194;42;82.2
6636;Puplinge;1505;710;47.18;701;592;109;84.45
6637;Russin;336;164;48.81;157;122;35;77.71
6638;Satigny;2264;1041;45.98;1022;849;173;83.07
6639;Soral;565;266;47.08;261;223;38;85.44
6640;Thônex;7548;3143;41.64;3110;2564;546;82.44
6641;Troinex;1518;740;48.75;731;622;109;85.09
6642;Vandoeuvres;1446;728;50.35;724;569;155;78.59
6643;Vernier;15377;5199;33.81;5129;4095;1034;79.84
6644;Versoix;6126;2262;36.92;2229;1825;404;81.88
6645;Veyrier;6650;2935;44.14;2907;2471;436;85
9250;GE-CH de l'étranger;26406;7744;29.33;7688;6792;896;88.35
9252;GE-autres;...;...;...;...;...;...;...
6702;Boécourt;681;191;28.05;190;152;38;80
6703;Bourrignon;232;84;36.21;83;61;22;73.49
6704;Châtillon (JU);354;128;36.16;126;101;25;80.16
6706;Courchapoix;315;90;28.57;90;67;23;74.44
6708;Courrendlin;2164;486;22.46;486;373;113;76.75
6709;Courroux;2282;588;25.77;583;457;126;78.39
6710;Courtételle;1769;501;28.32;499;426;73;85.37
6711;Delémont;7738;2362;30.52;2338;2019;319;86.36
6712;Develier;959;610;63.61;590;473;117;80.17
6713;Ederswiler;100;30;30;29;9;20;31.03
6715;Mervelier;432;140;32.41;139;120;19;86.33
6716;Mettembert;79;41;51.9;39;23;16;58.97
6718;Movelier;332;85;25.6;83;59;24;71.08
6719;Pleigne;319;132;41.38;131;88;43;67.18
6721;Rossemaison;486;161;33.13;157;120;37;76.43
6722;Saulcy;208;66;31.73;64;55;9;85.94
6724;Soyhières;346;94;27.17;93;71;22;76.34
6729;Haute-Sorne;4913;1345;27.38;1327;1070;257;80.63
6730;Val Terbi;2436;712;29.23;692;573;119;82.8
6741;Le Bémont (JU);282;82;29.08;82;63;19;76.83
6742;Les Bois;954;267;27.99;264;214;50;81.06
6743;Les Breuleux;1100;370;33.64;368;311;57;84.51
6744;La Chaux-des-Breuleux;82;32;39.02;31;28;3;90.32
6745;Les Enfers;121;63;52.07;61;44;17;72.13
6748;Les Genevez (JU);416;130;31.25;130;103;27;79.23
6750;Lajoux (JU);548;195;35.58;190;165;25;86.84
6751;Montfaucon;466;149;31.97;146;122;24;83.56
6753;Muriaux;434;166;38.25;165;127;38;76.97
6754;Le Noirmont;1344;436;32.44;427;347;80;81.26
6757;Saignelégier;1994;656;32.9;647;572;75;88.41
6758;Saint-Brais;194;78;40.21;77;60;17;77.92
6759;Soubey;145;40;27.59;40;34;6;85
6811;eux-Lugenz;301;102;33.88704318936877;100;72;28;72
6771;Alle;1348;414;30.71;403;338;65;83.87
6773;Beurnevésin;122;34;27.87;34;22;12;64.71
6774;Boncourt;993;264;26.59;262;220;42;83.97
6775;Bonfol;607;140;23.06;137;104;33;75.91
6778;Bure;563;161;28.6;158;116;42;73.42
6781;Coeuve;572;146;25.52;145;119;26;82.07
6782;Cornol;834;222;26.62;220;176;44;80
6783;Courchavon;221;82;37.1;82;58;24;70.73
6784;Courgenay;1680;489;29.11;482;396;86;82.16
6785;Courtedoux;614;186;30.29;182;158;24;86.81
6787;Damphreux;148;55;37.16;53;37;16;69.81
6789;Fahy;298;74;24.83;71;52;19;73.24
6790;Fontenais;1256;372;29.62;369;312;57;84.55
6792;Grandfontaine;320;93;29.06;91;60;31;65.93
6793;Lugnez;153;47;30.72;47;35;12;74.47
6800;Porrentruy;4722;1476;31.26;1462;1248;214;85.36
6806;Vendlincourt;472;139;29.45;134;97;37;72.39
6807;Basse-Allaine;951;264;27.76;260;191;69;73.46
6808;Clos du Doubs;1096;338;30.84;329;270;59;82.07
6809;Haute-Ajoie;983;318;32.35;314;224;90;71.34
6810;La Baroche;942;288;30.57;284;221;63;77.82
9260;JU-CH de l'étranger;...;...;...;...;...;...;...
